border_size=1
usage=map

Hh^Fms, Hh^Fms, Hh^Fms, Hh^Fms, Hh^Fms, Gg, Hh^Fms, Gg, Hh^Fp, Gg, Hh^Fms, Hh^Fms, Hh^Fds, Hh^Fds, Hh, Hh^Fds, Hh, Dd, Mm, Dd, Dd, Dd, Dd, Dd, Rd, Dd, Dd, Dd, Dd^Edpp, Dd, Dd, Dd, Dd^Edpp, Dd^Edpp, Dd^Edpp, Dd^Edpp, Dd^Edpp, Dd^Edpp, Dd^Edpp, Dd^Edpp, Dd^Edpp, Dd^Edpp, Dd^Edpp, Dd, Dd^Edpp, Dd
Hh^Fms, Hh^Fms, Hh^Fms, Hh^Fms, Hh^Fms, Hh^Fp, Hh^Fms, Hh^Fms, Hh^Fms, Hh^Fms, Hh^Fms, Hh^Fp, Hh^Fms, Hh^Fms, Md, Hh, Mm, Mm, Md, Md, Dd, Dd, Dd, Dd, Rd, Dd, Dd^Edp, Dd, Dd^Edpp, Dd, Dd, Dd, Dd, Dd^Edpp, Dd^Edpp, Dd, Dd^Edp, Dd^Edpp, Dd, Dd^Edpp, Dd^Edpp, Dd^Edpp, Dd, Dd^Edpp, Dd^Edpp, Dd^Edpp
Hh^Fms, Hh^Fms, Hh^Fms, Hh^Fp, Hh^Fp, Hh^Fms, Hh^Fms, Md, Md, Hh^Fp, Hh^Fms, Gs^Fms, Hh^Fms, Md, Md^Xm, Mm, Mm, Md, Hd, Hd, Dd, Dd, Dd, Dd, Rd, Ce, Dd, Dd^Do, Dd, Dd, Dd, Dd^Edpp, Dd^Edpp, Dd^Edpp, Dd^Edpp, Dd^Edp, Dd^Edp, Dd^Edpp, Dd^Edpp, Dd^Edpp, Dd^Edp, Dd^Edpp, Dd^Edpp, Dd^Edpp, Dd^Edpp, Dd^Edpp
Hh^Fms, Hh^Fms, Hh^Fms, Hh^Fms, Hh^Fms, Gs^Fms, Gs^Fms, Md, Md, Md, Hh, Hh^Fms, Mm, Mm, Md^Xm, Mm, Md, Hd, Md, Md, Dd, Dd, Dd, Dd, Rd, Rd, Rd, Dd^Vda, Dd, Dd, Hd, Dd, Dd^Edp, Dd^Edpp, Dd^Edpp, Dd^Edpp, Dd^Edpp, Dd, Dd^Edp, Dd^Edpp, Dd^Edpp, Dd, Dd^Edpp, Dd^Edpp, Dd^Edpp, Dd^Edpp
Wot, Hh^Fms, Hh^Fms, Hh^Fp, Hh^Fp, Hh^Fms, Hh^Fds, Hh^Fds, Hh, Md, Md, Hh, Mm, Md, Md, Md, Hd, Hd, Md, Md, Hd, Dd, Dd, Dd, Rd, Dd, Dd, Dd, Dd^Edpp, Hd, Hd, Dd, Dd^Edpp, Dd^Edpp, Dd^Edpp, Dd^Edpp, Dd^Edpp, Dd^Edpp, Dd^Edpp, Dd^Edpp, Dd^Edpp, Dd^Edpp, Dd, Dd^Edpp, Dd^Edpp, Dd^Edpp
Hh^Fms, Ww, Ww, Hh^Fms, Hh^Fms, Hh^Fms, Hh^Fds, Hh^Fp, Hh, Mm, Md^Xm, Md, Hd, Md, Hd, Hd, Dd, Hd, Hd, Md, Hd, Dd, Rd, Rd, Dd, Dd, Hd, Dd, Hd, Hd, Md, Hd, Md, Dd, Dd, Dd, Dd^Edpp, Dd^Edp, Dd^Edp, Dd^Edp, Dd^Edpp, Dd^Edpp, Dd^Edpp, Dd^Edpp, Dd^Edpp, Dd^Edpp
Hh^Fms, Hh^Fms, Wot, Wot, Hh^Fp, Hh^Fds, Hh^Fms, Hh^Fms, Md, Md^Xm, Md, Md, Dd, Dd, Dd, Dd^Edp, Dd^Edp, Dd^Edp, Dd, Hd, Dd, Rd, Hd, Hd, Hd, Hd, Hd, Md, Md, Hd, Md, Md, Md, Hd, Dd, Dd, Dd, Dd^Edpp, Dd, Dd, Dd, Dd^Edpp, Dd^Edpp, Dd^Edpp, Dd^Edpp, Dd^Edpp
Gg, Hh^Fms, Hh^Fds, Wot, Ww, Hh, Hh, Hh, Mm, Mm, Hd, Hd, Dd, Dd, Dd, Dd, Dd, Dd, Dd, Dd, Rd, Rd, Hd, Hd, Hd, Hd, Ydu, Hd, Md, Md, Md, Md, Hd, Dd, Dd, Dd, Dd, Dd, Dd, Dd, Dd^Edpp, Dd^Edpp, Dd^Edpp, Dd^Edpp, Dd^Edpp, Dd^Edpp
Hh^Fmw, Hh^Fp, Hh^Fmw, Hh^Fmw, Ww, Mm, Hh, Hh, Mm, Hd, Hd, Hd, Dd, Dd, Hd, Dd, Dd, Dd, Dd, Rd, Hd, Hd, Ydu, Ydu, Ydu, Ydu, Ydu, Hd, Hd, Md, Hd, Md, Hd, Hd, Hd, Dd, Dd, Dd, Dd, Dd, Dd, Dd^Edpp, Dd^Edpp, Dd^Edpp, Dd^Edpp, Dd^Edpp
Hh^Fmw, Hh^Fmw, Hh^Fmw, Hh, Ww, Md, Mm, Mm, Mm, Md, Dd, Dd, Dd, Hd, Md^Xm, Hd, Hd, Hd, Hd, Rd, Hd, Hd, Ydu, Ydu, Ydu, Ydu, Hd, Hd, Ydu, Hd, Ydu, Hd, Ydu, Hd, Hd, Hd, Hd, Dd, Dd^Edp, Dd, Dd, Dd^Es, Dd, Dd, Dd, Dd
Hh^Fdf, Hh^Fmw, Hh^Fmw, Mm, Ww, Mm, Mm, Mm, Md, Md, Hd, Dd, Hd, Md, Md^Xm, Md, Hd, Hd, Hd, Rd, Rd, Hd, Hd, Hd, Hd, Hd, Hd, Ydu, Ydu, Ydu, Ydu, Ydu, Hd, Hd, Md, Md^Xm, Md, Hd, Dd^Do, Dd^Edp, Dd, Dd, Dd^Edpp, Dd, Dd, Dd
Hh^Fdf, Hh^Fdf, Hh^Fdf, Mm, Mm, Wot, Wot, Wot, Md^Xm, Md, Hd, Hd, Hd, Md, Md, Md, Md, Hd, Hd, Hd, Hd, Rd, Hd, Hd, Hd, Ydu, Ydu, Ydu, Ydu, Ydu, Hd, Hd, Hd, Hd, Md, Md^Xm, Md, Hd, Dd^Edp, Dd, Dd^Edpp, 1 Dd, Dd, Dd, Dd, Dd
Hh, Hh^Fdf, Hh, Mm, Mm, Wot, Wot, Wot, Ww, Hd, Hd, Hd, Hd, Md, Md, Md, Hd, Md, Hd, Hd, Dd^Es, Rd, Dd^Es, Dd^Es, Dd^Es, Hd, Ydu, Ydu, Ydu, Hd, Dd, Md, Md, Hd, Hd, Md, Hd, Dd, Dd, Dd, Dd, Dd, Dd, Dd^Es, Dd, Dd
Mm, Hh, Mm, Mm, Mm, Mm, Md, Md, Md, Ww, Ww, Ww, Ww, Md, Md, Md, Hd, Hd^Edpp, Dd^Es, Dd^Edpp, Dd^Es, Rd, Dd^Es, Dd^Edpp, Dd^Edpp, Hd, Hd^Edpp, Hd, Hd, Hd, Hd, Hd, Hd, Hd, Md, Hd, Md, Md, Dd, Dd, Dd, Dd^Edpp, Dd, Dd, Dd, Dd
Mm, Mm, Mm, Mm, Dd, Md^Xm, Md, Md, Md, Md, Md, Md, Md, Wwf, Wwf, Mm, Hd, Md, Md, Dd^Es, Dd^Edpp, Rd, Rd, Dd^Es, Hd, Hd, Hd, Hd, Hd, Hd, Dd, Hd, Hd, Md, Md, Md, Md, Md, Md, Dd, Dd^Edp, Dd, Dd, Dd, Dd, Dd
Mm, Mm, Dd, Dd, Dd, Md, Dd, Dd, Dd, Hd, Hd, Hd, Md, Md, Md, Ww, Ww, Md, Hd, Hd, Hd, Dd^Es, Dd^Edpp, Rd, Rd, Hd, Dd, Dd, Dd, Hd, Dd, Dd, Dd, Hd, Hd, Md^Xm, Md^Xm, Md, Md, Dd^Edp, Dd, Dd, Dd^Edp, Dd^Edp, Dd, Dd
Dd, Dd, Dd, Dd, Dd, Dd, Dd, Dd, Dd, Dd, Dd, Dd, Hd, Md, Hd, Md, Wo, Ww, Hd, Md, Hd, Hd^Edpp, Dd, Dd^Edpp, Dd, Rd, Dd, Dd, Dd, Dd, Hd, Dd, Dd^Edpp, Hd, Hd, Md, Md^Xm, Md, Md^Xm, Md, Md, Dd, Dd, Dd, Dd, Dd
Rd, Rd, Rd, Dd^Edpp, Dd, Dd, Dd, Dd, Dd^Edpp, Dd, Dd, Dd, Dd, Hd^Edpp, Hd, Md, Wo, Gs^Gvs, Gs^Gvs, Md, Hd, Md, Md, Dd, Dd, Rd, Dd^Edpp, Dd^Edpp, Dd, Dd, Hd, Hd, Dd, Hd, Hd, Md, Dd, Md^Xm, Md, Hd, Hd, Dd, Dd, Dd, Dd, Dd
Hd, Dd, Hd, Rd, Dd, Dd^Edpp, Dd, Dd, Dd, Dd, Dd, Dd, Dd, Dd^Edpp, Hd^Edpp, Gs^Gvs, Gs^Gvs, Wo, Gs^Gvs, Gd^Gvs, Gd^Gvs, Hd, Md, Dd, Dd, Rd, Dd, Dd, Hd, Hd, Hd, Dd, Dd, Hd, Hd, Hd, Hd, Hd, Hd, Hd, Dd, Dd, Dd, Dd, Dd, Dd
Hd, Hd, Hd, Rd, Rd, Dd, Dd, Dd, Dd^Edpp, Dd, Dd, Dd, Dd, Dd^Edpp, Dd, Gd^Gvs, Gs^Gvs, Ww^Es, Ww, Gs^Gvs, Gs^Gvs, Hd, Md, Md, Dd, Rd, Dd^Edpp, Dd, Dd, Hd^Edp, Hd, Hd, Dd, Dd, Dd^Edpp, Hd, Hd, Hd, Hd, Dd, Hd, Md, Dd, Dd, Dd, Dd
Hd, Hd, Hd^Edpp, Dd, Dd, Rd, Rd, Dd, Dd, Dd, Dd, Dd, Dd, Dd, Dd, Dd^Vda, Gs^Gvs, Ww, Ww, Ww, Wwf^Es, Hd, Hd, Hd, Dd, Rd, Dd, Dd, Rd, Dd^Do, Hd, Dd, Dd, Dd, Dd, Hd, Hd, Md, Md, Md, Hd, Dd, Md, Md, Md, Md
Hd, Hd, Hd, Hd, Dd, Dd, Dd, Rd, Rd, Dd, Cd, Dd, Cd, Dd, Rd, Rd, Dd^Vda, Gg^Fet, Gs^Gvs, Gs, Hd, Ww, Ww, Dd^Edpp, Dd, Rd, Rd, Rd, Dd, Dd^Edp, Hd, Dd, Dd, Dd, Dd, Hd, Hd, Md, Dd, Dd, Dd, Dd, Hd, Hd, Hd, Hd
Dd, Hd, Md, Hd, Hd, Dd, Dd, Dd, Dd, Rd, Rd, Kd, Rd, Rd, Dd, Dd, Dd, Dd, Dd, Hd, Md, Hd, Ww, Dd, Hd^Edpp, Hd, Rd, Hd, Hd, Md, Hd, Dd, Dd, Dd, Dd, Hd, Hd, Hd, Dd, Dd, Hd, Hd, Hd, Hd, Dd, Dd
Md, Md, Md^Xm, Md, Md, Md, Hd, Dd, Dd, Dd, Rd, Rd, Dd, Dd, Dd, Dd, Dd, Dd^Edpp, Dd, Hd, Hd, Hd, Hd, Ww, Hd, Dd, Rd, Hd, Md, Md, Dd, Dd, Dd, Dd, Dd, Dd, Dd, Dd, Hd, Hd, Dd, Dd, Dd, Dd, Hd, Dd
Hd, Md^Xm, Md^Xm, Md^Xm, Md^Xm, Md, Md, Hd, Md, Rd, Dd, Dd, Dd, Dd, Hd, Dd, Dd^Edpp, Dd, Dd, Hd^Edpp, Dd, Dd, Dd, Ww, Ww, Dd, Dd, Rd, Dd, Dd, Dd, Dd, Dd, Dd, Dd, Dd, Dd, Hd, Dd, Hd, Hd, 2 Hd, Md, Hd, Md^Xm, Hd
Dd, Hd, Mm^Xm, Md, Mm^Xm, Md^Xm, Md, Md, Hd, Rd, Md, Hd, Hd, Hd, Md, Hd^Edpp, Md, Dd, Hd, Dd, Dd, Dd^Edpp, Dd, Dd^Edpp, Dd, Ww, Dd^Edp, Rd, Dd, Dd, Dd, Dd, Dd, Dd, Dd, Dd, Dd, Dd, Md, Md, Dd, Md^Xm, Md^Xm, Md^Xm, Md, Md^Xm
Dd, Dd, Dd, Md, Hd, Md, Hd, Dd, Rd, Rd, Md, Hd, Dd, Dd, Hd, Md^Xm, Md^Xm, Hd, Hd, Cd, Cd, Cd, Cd, Dd, Dd, Ww, Dd^Edp, Rd, Dd, Dd, Dd, Dd, Dd, Dd, Dd, Dd, Hd, Hd, Dd, Hd, Hd, Dd, Ww, Md, Wo, Wo
Dd, Dd, Dd^Edpp, Dd, Dd, Hd, Rd, Rd, Hd, Hd, Hd, Dd, Dd^Edp, Dd^Edp, Hd, Md, Mm^Xm, Md^Xm, Md^Xm, Md, Md, 3 Kd, Md^Xm, Md, Md, Ww, Dd, Rd, Dd, Dd^Edpp, Dd, Dd, Dd, Dd^Edpp, Dd, Hd, Hd, Dd, Md^Xm, Hd, Wot, Wo, Md, Ww, Md, Md^Xm
Dd, Dd, Dd^Edpp, Dd^Edp, Dd, Dd, Rd, Hd, Dd, Hd, Dd, Dd, Dd^Efm, Hd, Hd, Md, Md, Md^Xm, Hd, Md^Xm, Md^Xm, Md^Xm, Md^Xm, Md^Xm, Md, Ww, Dd, Rd, Dd, Dd, Dd, Dd^Edpp, Dd, Dd, Hd, Hd, Md, Md, Ww, Wo, Md, Md, Hd, Hd, Hd, Dd
Dd, Dd, Dd, Dd, Rd, Rd, Dd, Dd, Dd, Dd, Dd, Dd^Efm, Dd, Dd, Hd, Md, Ww, Wo, Wo, Hd, Hd, Md, Hd, Md, Ww, Ww, Ww, Ww^Bw|, Ww, Dd, Dd, Dd, Dd^Edp, Dd, Hd, Hd, Wwg, Ww, Hd, Hd, Hd, Hd^Edpp, Hd, Hd, Dd, Dd
Dd, Hd, Hd, Dd, Rd, Rd, Rd, Hd, Hd, Md, Hd, Hd, Hd^Edpp, Hd, Hd, Ww, Md, Md, Hd, Ww, Ww, Hd, Ww, Ww, Ww, Ww, Dd, Rd, Dd, Ww, Ww, Dd, Ww, Dd, Wo, Wwg, Md, Hd, Hd, Hd, Dd, Hd^Edpp, Dd^Edpp, Dd^Edpp, Dd, Dd
Dd, Dd, Hd, Dd, Rd, Hd, Md, Rd, Rd, Dd^Efm, Dd, Hd, Hd, Hd, Wwf, Wwf, Md, Md, Dd^Edpp, Hd, Ww, Ww, Dd, Dd^Edpp, Dd, Dd, Rd, Rd, Dd, Dd, Dd, Ww, Wo, Wo, Md, Md^Xm, Hd, Hd, Md^Xm, Dd, Dd, Dd, Dd, Hd, Hd, Dd
Dd, Dd, Hd, Hd, Rd, Hd, Md, Md, Hd, Rd, Cd, Hd, Wwf, Wwr, Gs^Gvs, Gs^Gvs, Gd^Gvs, Hd, Gd^Gvs, Gd^Gvs, Dd^Edpp, Dd, Dd^Es, Dd, Rd, Rd, Rd, Dd, Dd, Dd, Dd, Dd, Dd, Dd, Dd, Hd, Md, Md^Xm, Md^Xm, Dd, Dd, Dd, Md^Xm, Md^Xm, Md^Xm, Mm^Xm
Dd, Dd, Dd, Dd, Rd, Md, Md, Md, Hd, Cd, Ww, Wwr, Gs^Gvs, Gs^Gvs, Md, Gd^Gvs, Rd, Dd^Vda, Dd^Edpp, Dd, Dd, Dd, Rd, Rd, Dd, Dd, Dd, Rd, Rd, Dd, Dd, Dd^Edp, Dd, Dd, Hd, Hd, Md, Md^Xm, Md^Xm, Md^Xm, Md^Xm, Md^Xm, Md^Xm, Md^Xm, Dd, Dd
Rd, Dd^Edpp, Rd, Rd, Hd, Md, Gs^Gvs, Ww, Wo, Ww, Wo, Wo, Gd^Gvs, Gd^Gvs, Md, Dd, Rd, Dd^Edpp, Dd, Dd, Rd, Rd, Dd, Dd, Dd, Dd, Dd, Dd, Dd, Rd, Rd, Dd, Dd, Dd^Edp, Dd, Hd, Hd, Md, Hd, Md, Dd, Md^Xm, Hd, Md^Xm, Dd, Dd
Dd, Rd, Rd, Hd, Gd^Gvs, Gd^Gvs, Gs^Gvs, Ww, Wo, Ww, Gs^Gvs, Gg^Fet, Gd^Gvs, Gd^Gvs, Gs, Dd, Rd, Dd, Rd, Rd, Dd, Dd, Dd, Dd, Dd, Dd, Dd, Dd, Dd, Dd, Dd, Rd, Rd, Dd, Dd, Dd, Dd, Dd, Dd, Dd, Dd^Edpp, Dd, Dd^Edpp, Dd, Rd, Rd
Dd, Dd, Dd^Edpp, Rd, Rd, Gd^Gvs, Gs^Gvs, Ww, Ww, Ww, Gd^Gvs, Gd^Gvs, Gd^Gvs, Gd^Gvs, Dd^Vda, Dd, Rd, Rd, Dd, Dd, Dd^Edpp, Dd, Dd, Dd, Ydu, Dd^Edpp, Dd, Dd, Hd, Dd, Hd, Dd, Dd, Rd, Rd, Rd, Rd, Dd^Vda, Dd^Do, Dd^Vda, Rd, Dd, Rd, Rd, Dd, Dd
Dd, Dd^Edpp, Dd^Es, Dd^Vda, Gd^Gvs, Rp, Wwr^Bw\, Ww, Gs^Gvs, Gs^Gvs, Gd^Gvs, Gd^Gvs, Gd^Gvs, Gd^Gvs, Gd, Rd, Gd, Dd, Dd, Dd^Edp, Dd, Dd, Ydu, Ydu, Ydu, Ydu, Dd^Edp, Dd^Edp, Hd, Hd, Hd, Hd, Hd, Hd, Hd, Hd, Dd, Rd, Rd, Dd, Rd, Rd, Dd, Dd^Edpp, Dd, Dd
Dd, Dd, Hd, Gd^Gvs, Gs^Gvs, Gs^Gvs, Wwr, Rp, Rp, Gs^Gvs, Rd, Gd^Gvs, Rd, Dd^Vda, Rd, Rd, Gd, Dd, Dd, Dd^Edp, Dd, Dd, Ydu, Ydu, Dd, Dd^Edp, Dd, Dd, Dd^Edpp, Hd, Md, Md, Md, Md, Md, Md, Hd, Dd, Dd, Rd, Dd, Dd, Dd, Dd, Dd, Dd
Dd, Dd, Gs^Gvs, Gs^Gvs, Wo, Wo, Gd^Gvs, Gs^Gvs, Dd^Vda, Rd, Rd, Rd, Rd, Rd, Gs, Gs, Gd^Gvs, Dd, Dd^Edpp, Dd^Edp, Dd^Edp, Dd, Dd, Dd, Dd, Dd, Dd, Dd^Edpp, Dd, Md, Md, Md, Md, Md^Xm, Md^Xm, Md, Md, Dd, Dd, Dd, Dd, Dd, Dd, Dd, Ydu, Ydu
Dd, Dd, Gs^Gvs, Wo, Gs^Gvs, Gd^Gvs, Gd^Gvs, Gd^Gvs, Hd, Rd, Dd^Es, Rd, Rd, Rd, Dd^Vda, Gd^Gvs, Dd, Dd^Edp, Dd, Dd^Edp, Dd^Edp, Dd, Dd, Dd^Edpp, Dd, Dd, Dd^Vdt, Dd^Do, Dd^Vdt, Dd^Edpp, Dd, Hd, Hd, Md, Md, Md^Xm, Hd, Hd, Hd, Hd, Hd, Hd, Hd, Dd, Ydu, Ydu
Dd, Gs^Gvs, Ww, Ww, Dd, Dd, Dd, Dd, Dd^Edpp, Dd^Edpp, Dd, Dd^Vda, Dd, Dd, Dd^Edpp, Dd, Dd, Dd, Dd, Dd^Edp, Dd, Dd, Dd, Dd, Dd, Dd, Dd, Dd, Dd, Dd, Dd, Dd, Hd, Md, Hd, Md, Hd, Hd, Md, Hd, Md, Md, Md, Hd, Ydu, Ydu
Dd, Ww, Hd, Hd, Dd, Dd, Dd, Dd, Dd, Dd, Dd, Dd, Dd, Dd, Dd, Dd, Dd, Dd, Dd, Dd, Dd, Dd, Dd, Dd, Dd, Dd, Dd, Dd, Dd, Dd, Dd, Dd, Hd, Hd, Hd, Hd, Hd, Hd, Md, Md, Md, Md, Md, Hd, Ydu, Ydu