border_size=1
usage=map

Gs^Fds, Gg, Gs^Fds, Ww, Ww, Gs^Fds, Gg, Gg, Gg, Gs^Fds, Gs^Fds, Gs^Fds, Gs^Fds, Gs^Fds, Hh^Fms, Hh^Fms, Mm, Mm, Mm, Mm, Mm, Mm, Mm, Ww, Ww, Hh^Fms, Hh^Fms, Hh^Fms, Hh^Fms, Gg, Gg, Gg, Gg, Gg, Gg, Gg, Gg, Gg, Hh^Fms, Hh^Fms, Hh^Fms, Hh^Fms, Mm, Hh^Fms, Mm, Mm, Mm, Mm, Wo, Mm
Gs^Fds, Gs^Fds, Gg, Gs^Fds, Ww, Gg, Gg, Gg, Gg, Gs^Fds, Gg, Gg, Gg, Gs^Fds, Gs^Fds, Hh^Fms, Hh^Fms, Mm, Hh^Fms, Mm, Hh^Fms, Hh, Hh^Fms, Ww^Es, Ww, Gg, Gg, Hh^Fms, Gs^Vc, Gg, Gg, Gg, Gs^Fms, Gg, Gg, Gg, Gg, Gg, Gg, Gg, Gs^Vc, Hh^Fds, Mm, Mm, Mm, Mm, Mm, Mm, Mm, Wo
Gs^Fds, Gs^Fds, Gs^Fds, Gg, Ww, Ww, Ww, Gg, Gg, Gg, Gg, Gg, Gg, Gg, Gg, Gg, Gs^Fds, Gs^Fds, Hh^Fms, Hh, Gg, Gg, Gg, Gg, Ww, Ww, Gg, Gg, Gg, Gs^Fms, Gs^Fms, Gs^Fms, Gg, Gs^Fms, Gg, Gg, Gg, Gs^Vc, Gg, Gg, Hh^Fms, Hh^Fms, Hh, Mm, Ww^Es, Ww^Es, Ww, Ww, Ww, Ww
Gs^Fds, Gs^Fds, Gg, Gg, Ww, Wot, Wot, Ww, Ww, Ww, Gg, Gs^Vc, Gg, Gg, Gg, Gs^Fds, Gg, Gg, Gg, Gg, Gg, Gg, Gg, Gg, Gg, Ww, Ww, Ww, Ww, Gg, Wwg, Gg, Gg, Gs^Vc, Gg, Gs^Fms, Hh^Fp, Gg, Gg, Hh^Fms, Mm, Hh^Fds, Mm, Hh^Fms, Hh, Ww, Ww, Ww, Ww, Ww^Es
Gg, Gs^Fds, Gg, Gg, Gg, Ww, Wot, Ww, Wot, Ww, Ww, Gg, Gg, Gs^Fds, Gs^Fds, Gg, Gg, Gg, Gg, Gg, Gg, Gg, Gg, Gg, Gg, Gg, Gg, Gg, Gs^Fms, Ww, Ww, Gg, Gg, Gs^Fms, Gs^Fms, Hh^Fp, Hh, Hh^Fds, Gg, Chr, Khr, Hh^Fms, Mm, Mm, Hh^Fms, Ww, Ww^Es, Ww, Mm, Ww
Gg, Gs^Fds, Gs^Fds, Gs^Fds, Gg, Ww, Ww, Gs^Fds, Gs^Fds, Wwg, Gg, Gs^Fds, Gg, Gg, Gg, Gg, Gg, Gs^Fds, Gg, Gg, Gg, Gg, Gg, Gg, Gg, Gg, Gg, Gs^Fds, Gs^Fms, Wwg, Gg, Ww, Ww, Gg, Gs^Fms, Gg, Gg, Gs^Fms, Gg, Chr, Hh, Hh, Mm, Mm, Mm, Hh, Hh^Fds, Md, Hh^Fds, Hh
Gs^Fds, Gs^Fds, Gg, Gg, Gg, Ww, Ww, Ww, Ww, Wot, 2 Ke, Gg, Gg, Gg, Gg, Gg, Gg, Gg, Gg, Gg, Gg, Gg, Gg, Gg, Gg, Gg, Gg, Gs^Fds, Gg, Gg, Gg, Gg, Ww, Gg, Gg, Gg, Gg, Gs^Fms, Gs^Fms, Hh, Hh, Hh^Fp, Hh^Fp, Md, Md, Hh^Fds, Hh^Fms, Md, Hh^Fds, Hh^Fds
Gs^Fds, Gg, Gs^Fds, Gs^Vc, Gg, Gg, Ww, Ww, Gg, Ww, Ce, Ce, Gg, Gg, Hh^Fds, Gg, Gg, Gg, Hh, Gg, Hh^Fms, Gg, Gg, Gg, Gg, Gg, Gg, Gg, Gg, Ss, Ww, Ww, Gg, Gg, Gg, Gg, Gs^Fms, Mm, Mm, Mm, Hh^Fms, Hh, Hh, Gg, Gg, Gg, Gg, Hh^Fms, Gg, Mm
Gs^Fds, Gs^Fds, Gg, Gg, Gs^Fds, Ww, Gg, Gg, Gg, Gg, Gg, Ce, Gs^Fds, Hh^Fds, Hh^Fp, Hh^Fp, Hh^Fp, Hh^Fms, Gg, Gg, Gg, Hh^Fms, Hh^Fp, Gg, Gg, Gg^Es, Gg, Gg, Gg, Gg, Wwg, Gs^Fms, Gg^Es, Gg, Gg, Gs^Fms, Gs^Fms, Hh^Fms, Hh^Fms, Gs^Fds, Gg, Gs^Fds, Hh^Fms, Mm, Mm, Gg, Gg, Gg, Hh^Fms, Hh^Fms
Gs^Fds, Gs^Fds, Gg, Gg, Gs^Fms, Ww, Gg, Gs^Vc, Gs^Fds, Gs^Fms, Gs^Fms, Gg, Gs^Fds, Hh^Fds, Hh^Fds, Hh^Fp, Hh, Gg, Gg, Gg, Gg, Hh^Fp, Hh, Hh^Fms, Gg^Es, Gg, Gg, Gg, Gg, Gg, Gg, Wwg, Wwg, Wwg, Wwg, Wwg, Gg, Gg, Gg, Gs^Fds, Gs^Fds, Gg, Hh^Fms, Hh^Fds, Mm, Hh, Gg, Gg, Gg, Gg
Gg, Gg, Gg, Gg, Gs^Fms, Ww, Gg, Gg, Gs^Fds, Gs^Fds, Gs^Fms, Gs^Fds, Gg, Hh^Fds, Gs^Fms, Hh, Hh^Fds, Hh, Gs^Fms, Gg, Gg, Gg, Gs^Fms, Gs^Fms, Gs^Fms, Gg, Gg, Gg, Gg, Gg, Wwg, Wwg, Gs^Fds, Gs^Fds, Gg, Wwg, Wwg, Gg, Gg, Gg, Gg, Gg, Gg, Hh^Fp, Gs^Fms, Hh^Fms, Hh, Gg, Gg, Gs^Fms
Gg, Gs^Fds, Gg, Gg, Gg, Ww, Ww, Gs^Fms, Gg, Gs^Fms, Gg, Gg, Hh^Fms, Hh^Fds, Gs^Fms, Gs^Fms, Gs^Fms, Hh^Fds, Gs^Fms, Gs^Fms, Gg, Hh^Fds, Gg, Gs^Fms, Gg, Gg, Gg, Gg, Wwg, Wwg, Ss, Ss, Gs^Fds, Ss^Xo, Gg, Gg, Ss, Wwg, Wwg, Hh^Fms, Hh^Fms, Gs^Fds, Gs^Fds, Mm, Hh, Gs^Fms, Hh^Fms, Hh, Hh, Gg
Gg, Gg, Gg, Gg, Gg, Gg, Wwg, Hh^Fms, Gg, Gg, Gs^Fms, Gg, Hh^Fms, Gs^Fms, Gs^Fms, Hh^Fds, Hh^Fds, Hh^Fp, Gg, Gg, Gg, Gg, Ss, Gg, Ss, Gg, Wwg, Wwg, Ss, Ss, Ss, Ss, Gs^Fds, Gg, Gg, Gs^Fds, Ss, Wwg, Wwg, Gg, Gg, Gs^Fds, Gs^Fds, Hh, Hh, Hh^Fms, Hh^Fms, Hh^Fms, Gs^Fms, Gg
Gg, Gg, Gg, Gg, Gg, Ww, Ww, Ww, Ww, Gg, Gg, Gg, Gg, Gs^Fms, Gg, Gs^Fp, Gg, Gs^Fms, Gs^Fms, Gg, Gg, Gg, Wwg, Wwg, Wwg, Ss, Wwg, Wwg, Gg, Ss, Gg, Ss, Gg, Gg, Gg, Gs^Fds, Gs^Fds, Ss, Gs^Fds, Wwg, Wwg, Gg, Gs^Fds, Gg, Gg, Hh, Hh^Fms, Hh^Fms, Gs^Fms, Gg
Gg, Gg, Gg, Gg, Gg, Ss, Ww, Ww, Ww, Gg, Gg, Gg, Gg, Gs^Vc, Gg, Gg, Gg, Gs^Fms, Gg, Gg, Ss, Ss, Wwg, Wwg, Ss, Wwg, Gg, Gg, Gg^Xo, Gg, Gg, Gg, Gg, Gg, Gs^Fms, Gs^Fms, Gg, Gg, Gg^Xo, Gg, Ss, Wwg, Wwg, Gg, Gs^Fms, Gs^Fms, Gs^Fms, Gg, Gg, Gg
Gg, Gg, Gg, Gg, Gg, Ss, Ww, Ww, Ww, Gg, Gg, Gg, Gg, Gg, Gg, Gs^Fms, Gg, Gg, Gg, Gg, Ss, Wwg, Ww, Ss, Ss, Ss, Gs^Fds, Gs^Fds, Gg, Gg, Gg, Gg, Gg, Gg, Gg, Gg, Gg, Gg, Gg, Gg, Ss, Ss, Ss, Wwg, Gs^Fms, Gs^Fms, Gg, Gs^Fms, Gg, Gg
Gg, Gg, Gg, Gs^Fms, Gs^Fms, Gg, Gs, Gg, Gs^Fms, Ww, Ww, Gg, Gs^Vc, Gg, Gs^Fms, Gs^Fms, Gg, Gg, Gg, Gg, Gg, Wwg, Ww, Ss, Gg, Gg, Gg, Gg, Gg, Gg, Gg, Gg, Gg, Gg, Gg, Gg, Gg, Gg, Gg, Gg, Gg, Gg, Gg, Wwg, Wwg, Gg^Efm, Gg, Gg, Gg, Gg
Gg, Gg, Gs, Gs^Fds, Hh^Fp, Hh^Fds, Gs, Hh^Fp, Gg, Gg, Ww, Gg, Gg, Gg, Gs^Fms, Gs^Fms, Gg, Gg, Gg, Gg, Gg, Wwg, Wwg, Ss, Gg, Gg, Gg, Gg, Gs^Fms, Gg, Gg, Gg, Gg, Gg^Xo, Gg, Gg, Gg, Gg, Gs^Fds, Gg, Gg, Gg, Gg, Gg, Wwg, Ww, Gg, Gg, Gg, Gg
Gg, Gg, Gg, Gg, Gg, Gg, Gg, Gg, Ww, Gg, Ww, Ww, Ww, Gs^Fms, Gs^Fms, Gs^Fms, Gg, Gg, Gg, Gg, Ss, Wwg, Wwg, Ss, Gg, Gg^Xo, Gg, Gs^Fms, Gg, Gg, Gg, Gg, Gg, Gg^Xo, Gg, Gg, Gs^Fds, Gs^Fds, Gg, Gg, Gg, Ss^Xo, Gg, Gg, Ww, Ww, Gg, Gg, Gg, Gg
Gg, Gg, Gg, Gg, Ss, Gg, Gg, Gs^Vc, Gg^Fet, Ww, Ww, Gg, Gg, Ww, Wwf, Gs^Fms, Gg, Gg, Gg^Efm, Gg^Efm, Ss, Wwg, Wwg, Gg, Gs^Fds, Gg, Gg, Gs^Fds, Gg, Gg, Gs^Fds, Gs^Fds, Gg, Gg, Re, Gs^Fms, Gg, Gs^Fds, Gg, Gg, Gg, Gg, Gg, Gg, Ww, Wwg, Gg, Gg, Gg, Gg
Gg, Gg, Gs^Fds, Gg, Gg, Gg, Gg, Gg, Gg, Gg, Wwf, Gg, Gg, Gg, Gg, Wwf, Ww, Gg, Gg, Ss, Ss, Wwg, Wwg, Gs^Fds, Gs^Fds, Gg, Gg, Gg, Gg, Gs^Fds, Gs^Fds, Gg, Gg^Efm, Gg^Efm, Re, Gg, Gg, Gg, Gg, Gg, Gg, Gg, Ss, Ss, Wwg, Wwg, Gg, Gg, Gg, Gg
Gg, Gs^Fds, Gs^Fds, Gg, Gg, Gg, Gg, Gg, Gg, Ss, Ww, Ss, Gg, Gg, Gg, Gg, Ww, Ss, Gg, Ss, Ss, Wwg, Wwg, Ss, Ss, Gg, Gg, Gg, Gg, Gg, Gs, Gg, Gg, Gg, Gg, Gg, Gg, Gg, Gg, Gg, Gg, Ss, Ss, Wwg, Gg, Gg, Gg, Gg, Gg, Gg
Gg, Gg, Gg, Gg, Gg, Gg, Gg, Gg, Wo, Ss, Wo, Ww, Ww, Gg, Gg, Gg, Ww, Ss, Gg, Gg, Gg, Gg, Gg, Wwg, Wwg, Wwg, Wwg, Gg, Gg^Xo, Gg, Gs^Fds, Gg, Gg, Gg, Gg, Gg, Gg, Gg, Gg^Xo, Gg, Wwg, Ss, Wwg, Wwg, Gg, Gg, Gg, Gg, Gg, Gg
Gg, Gg, Gg, Gg, Gs^Fds, Gg, Gs^Fds, Gg, Ss, Wo, Ww, Wo, Wo, Ww, Ww, Ss, Ww, Ww, Ww, Ss, Ss, Gg, Gg, Gg, Wwg, Ww, Wwg, Ss, Gg, Gs^Fds, Gs^Fms, Gg, Ss, Gg, Re, Gg, Gg, Gg, Gg, Ss, Wwg, Wwg, Gg, Gg, Gg, Gg, Gg, Gg, Gg, Gg
Gg, Gg, Gg, Gs^Fms, Gg, Gg, Gg, Gs^Fds, Gg, Ss, Ss, Gg, Gg, Wo, Gg, Ww, Gg, Ww, Ww, Ww, Ww, Gg, Ss, Ss, Ss, Ww, Wwg, Gg, Gg, Gg, Gg, Gs^Fds, Ss, Ss, Gs^Fds, Gg, Gg, Gg, Gg, Ss, Wwg, Gg, Gg, Gg, Ss, Gs^Fds, Gs^Fds, Gg, Gg, Gg
Gg, Gs^Fds, Gs^Fds, Gg, Gg, Gg, Gg, Gs^Fds, Gg, Gg, Gg, Gg, Gg, Gg, Gs^Fds, Gs^Fds, Gg, Gg, Ss, Ww, Ww, Gg, Ww, Ww, Ww, Ww, Ww, Ss, Ss^Xo, Re, Gg, Ss, Ww, Ww, Ww, Gs^Fds, Gg, Gg, Gg^Xo, Gg, Wwg, Gg, Ss, Wwg, Ww, Wwg, Gg, Wwg, Wog, Gg
Gg, Gg, Gg, Gg, Gg, Gs^Vc, Gg, Gg, Gs^Fms, Gg, Gg, Gg, Gg, Gg, Gg, Gs^Fds, Gg, Gg, Gs^Fms, Ss, Ss, Ww, Wwg, Ss, Ss, Ww, Ww, Ss, Gg, Gg, Ww, Ww, Gg, Gg, Gg, Ww, Ww, Ss, Ss, Ss, Wwg, Ss, Ww, Wo, Gg, Ww, Ww, Wwg, Ww, Wog
Gg, Gg, Gg, Ww, Wo, Gg, Gg, Gg, Gg, Gg, Gg, Gg, Gs^Fms, Gg, Gg, Gg, Gg, Gs^Fms, Gg, Gg, Gg, Wwg, Wwg, Wwg, Gg, Gg, Gg, Ww, Ww, Ww, Gs^Fms, Gs^Fds, Gg, Gg, Gg, Gg, 1 Re, Ww, Ww, Ww, Ww, Wo, Gg, Gg, Gg, Gg, Re, Ww, Ss, Ww
Gs^Fds, Gs^Fds, Ww, Wwg, Wwg, Gg, Gs^Fds, Gg, Gs^Fds, Gg^Es, Gg, Gs^Fms, Gs^Fms, Gg, Gg, Gg, Gs^Fds, Gs^Fms, Gs, Gs, Ss, Wwg, Wwg, Gg, Gs^Fms, Gs^Fms, Gs^Fms, Gg, Gg, Gg, Gs^Fms, Gg, Gg, Gg, Gg, Gg, Re, Gg, Gg, Wwg, Gs^Fms, Gg, Gg, Gg, Gg, Gg, Gg, Ss, Ss, Wwg
Gs^Fds, Gs^Fds, Gs^Fms, Ww, Gg, Gs^Fds, Gg, Gg, Gs^Fms, Gg, Gg, Gs^Fms, Gg, Gg, Gs^Fds, Gg, Gg, Gg, Gg, Gg, Gg, Wwg, Wwg, Gg, Gg, Gs^Fms, Gs^Fms, Gg, Gs^Vh, Gs^Fds, Gg, Gg, Gg, Gg, Gg, Gg, Gg, Gg, Gg, Gs^Fms, Gs^Fms, Gs^Fds, Gg, Gg, Gg, Gg, Gg, Gg, Gg, Wwg
Gg, Gs^Fms, Gs^Fds, Gs^Fms, Gg, Gg, Gg^Es, Gg, Gg, Gg, Gs^Fms, Gg, Gs^Fds, Hh^Fds, Hh^Fmw, Gg, Hh^Fds, Gs, Gg, Gg, Gg, Gg, Gg, Gg, Gg, Gg, Gg, Gg, Gg, Gg, Gg, Gg, Gs^Fds, Gg, Gg, Gg, Gg, Gg, Gg, Gg, Gs^Fds, Gg, Gg, Gg, Gg, Gg, Gg, Gg, Gg, Gg
Gg, Gs^Fds, Gg, Gg, Gg, Gg, Gg, Gg, Gg, Gg, Gg, Gg, Gs^Fds, Hh^Fp, Hh^Fmw, Hh^Fp, Hh^Fp, Gs^Fms, Hh^Fms, Gg, Gg, Gg, Gg^Efm, Gg, Gg, Gg, Gg, Gg, Gg, Gg, Gg, Gg, Gs^Fds, Gg, Gg, Gs^Fms, Gg, Gg, Gg, Gg, Gg, Gg, Gg, Gs^Vc, Re, Gg, Gg, Re, Re, Gg
Gg, Gg, Gg, Gg, Gg, Gg, Gg, Gg, Gg, Gg, Gs^Fms, Gs^Fms, Gs^Fms, Hh^Fds, Hh^Fp, Hh^Fds, Hh^Fds, Hh^Fds, Hh^Fms, Gg, Gg, Gg, Gg, Gs^Fms, Gg, Gg, Gs^Fms, Gg, Gs^Fds, Gs^Fms, Gg, Gs^Fds, Gg, Gs^Fms, Gg, Gg, Gg, Gg, Gg, Gg, Gg, Gg, Gg, Gg, Gg, Gg, Gg, Gg, Gg, Gg
Gg, Gg, Gg^Es, Gg^Es, Gg^Es, Gg, Gg, Gg, Gg, Gg, Gg, Gg, Gg, Gg, Gs^Fms, Gs^Fms, Gll^Fp, Gs^Fms, Gs^Fms, Gg, Gg, Gg, Gg, Gg, Gg, Gg, Gg, Gg, Gg, Gg, Gg, Gs^Fms, Gg, Gg, Gg, Gg, Gg, Gg, Gs^Fds, Gs^Fms, Gs^Fms, Gs^Fms, Gg, Gg, Gg, Gg, Gg, Gg, Gg, Gg