border_size=1
usage=map

Gs^Fds, Gg, Gs^Fds, Ww, Ww, Gs^Fds, Gg, Gg, Gg, Gs^Fds, Gs^Fds, Gs^Fds, Gs^Fds, Gs^Fds, Hh^Fms, Hh^Fms, Mm, Mm, Mm, Mm, Mm, Ss, Ss, Ww, Ww, Ss, Ss, Ss, Ss, Gg, Hh^Fp, Hh^Fp, Gs^Fms, Gg, Gs^Fms, Hh^Fms, Hh^Fms, Hh^Fms, Hh^Fms, Hh^Fms, Hh^Fms, Hh^Fms, Mm, Hh^Fms, Mm, Mm, Mm, Mm, Wo, Mm
Gs^Fds, Gs^Fds, Gg, Gs^Fds, Ww, Gg, Gg, Gg, Gg, Gs^Fds, Gg, Gg, Gg, Gs^Fds, Gs^Fds, Hh^Fms, Hh^Fms, Mm, Hh^Fms, Mm, Hh^Fms, Ss, Wwg, Ss, Ww, Ss, Wwg, Ss, Wwg, Ss, Gs, Hh^Fp, Gs^Fms, Gs^Fms, Gg, Gg, Gs^Gvs, Gg, Gg, Hh^Fms, Hh^Fp, Hh^Fds, Mm, Mm, Mm, Mm, Mm, Mm, Mm, Wo
Gs^Fds, Gs^Fds, Gs^Fds, Gg, Ww, Ww, Ww, Gg, Gg, Gg, Gg, Gg, Gg, Gg, Gg, Gg, Gs^Fds, Gs^Fds, Hh^Fms, Hh, Gg, Ss, Ss, Ss, Ww, Ww, Ss, Ss, Ss, Ss, Gs, Gs, Gg, Gs^Fms, Rb, Gg^Gvs, Gg^Gvs, Gg^Gvs, Gg, Gs^Fms, Gs^Fms, Hh^Fms, Gs^Vc, Mm, Ww^Es, Ww^Es, Ww, Ww, Ww, Ww
Gs^Fds, Gs^Fds, Gg, Gg, Ww, Wot, Wot, Ww, Ww, Ww, Gg, Gs^Vc, Gg, Gg, Gg, Gs^Fds, Gg, Gg, Gg, Gg, Gs, Ss, Ss, Ss, Ss, Ww, Ww, Ww, Ww, Ss, Wwg, Gg^Gvs, Gg^Gvs, Gs^Vc, Rb, Gg, Gg, Gg^Gvs, Gg^Gvs, Gg, Gs^Fms, Rb, Gs^Fms, Hh^Fms, Hh, Ww, Ww, Ww, Ww, Ww^Es
Gg, Gs^Fds, Gg, Gg, Gg, Ww, Wot, Ww, Wot, Ww, Ww, Gg, Gg, Gs^Fds, Gs^Fds, Gg, Gg, Gg, Gg, Gg, Gg, Gg, Gg, Gg, Gg, Ss, Ss, Ss, Ss, Ww, Ww, Gg, Gg, Gs^Fms, Gg, Rb, Rb, Rb, Rb, Gg, Rb, Rb, Gs^Fms, Mm, Hh^Fms, Ww, Ww^Es, Ww, Mm, Ww
Gg, Gs^Fds, Gs^Fds, Gs^Fds, Gg, Ww, Ww, Gs^Fds, Gs^Fds, Wwg, Gg, Gs^Fds, Gg, Gg, Gg, Gg, Gg, Gs^Fms, Gg, Gg, Gg, Gg, Gg, Gs, Gs, Gg, Gs, Ss, Gs, Ss, Gg, Ww, Ww, Gg^Gvs, Gs^Fms, Gs^Vc, Rb, Gg, Gg^Gvs, Rb, Gg, Gs^Fms, Gs^Fms, Mm, Mm, Hh, Hh^Fds, Md, Hh^Fds, Hh
Gs^Fds, Gs^Fds, Gg, Gg, Gg, Ww, Ww, Ww, Ww, Wot, 2 Ke, Gg, Gg, Gg, Gg, Gg, Gg, Gg, Gs^Fms, Gg, Gg, Gg, Gg, Gg, Gg, Gg, Gg, Gs, Gg, Gg, Gg, Gg, Ww, Gg, Gg^Gvs, Gg, Rb, Gg^Gvs, Gg, Rb, Rb, Gg, Rb, Gs^Fms, Gs^Fms, Hh^Fds, Hh^Fms, Md, Hh^Fds, Hh^Fds
Gs^Fds, Gg, Gs^Fds, Gs^Vc, Gg, Gg, Ww, Ww, Gg, Ww, Ce, Ce, Gg, Gg, Hh^Fds, Gg, Gg, Gg, Hh, Gs^Fms, Hh^Fms, Gg, Gs^Fms, Gg, Gg, Gg, Gg, Gg, Gg, Ss, Ww, Ww, Gg, Gg^Gvs, Gg^Gvs, Gg^Gvs, Gs^Fms, Gs^Fms, Gg, Gs^Fms, Gg, Rb, Gg, Rb, Gg, Gg, Gg, Hh^Fms, Gg, Mm
Gs^Fds, Gs^Fds, Gg, Gg, Gs^Fds, Ww, Gg, Gg, Gg, Gg, Gg, Ce, Gs^Fds, Hh^Fds, Hh^Fp, Hh^Fp, Hh^Fp, Hh^Fms, Gg, Gs^Fms, Gg, Hh^Fms, Hh^Fp, Gs^Fms, Gg, Gg^Es, Gg, Gg, Gg, Gg, Wwg, Gs^Fms, Gg^Es, Gg, Gg, Gs^Fms, Gs^Fms, Hh^Fms, Hh^Fms, Gg, Gs^Vc, Rb, Gg, Gs^Vc, Gg, Gg^Gvs, Gg^Gvs, Gg, Hh^Fms, Hh^Fms
Gs^Fds, Gs^Fds, Gg, Gg, Gs^Fms, Ww, Gg, Gs^Vc, Gs^Fds, Gs^Fms, Gs^Fms, Gg, Gs^Fds, Hh^Fds, Hh^Fds, Hh^Fp, Hh, Gg, Gg, Gg, Gg, Hh^Fp, Hh, Hh^Fms, Gg^Es, Gg, Gg, Gg, Gg, Gg, Gg, Wwg, Wwg, Wwg, Wwg, Wwg, Gg, Gg, Gg, Gs^Fds, Gg^Gvs, Gg^Gvs, Gg^Gvs, Gg, Gs^Fms, Gg, Gg, Gg, Gg, Gg
Gg, Gg, Gg, Gg, Gs^Fms, Ww, Gg, Gg, Gs^Fds, Gs^Fds, Gs^Fms, Gs^Fds, Gg, Hh^Fds, Gs^Fms, Hh, Hh^Fds, Hh, Gs^Fms, Gg, Gg, Gg, Gs^Fms, Gs^Fms, Gs^Fms, Gg, Gg, Gg, Gg, Gg, Wwg, Wwg, Gs^Fds, Gs^Fds, Gg, Wwg, Wwg, Gg, Gg, Gg, Gg, Gg, Gg, Hh^Fp, Gs^Fms, Hh^Fms, Hh, Gg, Gg, Gs^Fms
Gg, Gs^Fds, Gg, Gg, Gg, Ww, Ww, Gs^Fms, Gg, Gs^Fms, Gg, Gg, Hh^Fms, Hh^Fds, Gs^Fms, Gs^Fms, Gs^Fms, Hh^Fds, Gs^Fms, Gs^Fms, Gg, Hh^Fds, Gg, Gs^Fms, Gg, Gg, Gg, Gg, Wwg, Wwg, Wwg, Ss, Ss, Ss^Xo, Gg, Gg, Ss, Wwg, Wwg, Hh^Fms, Hh^Fms, Gs^Fds, Chr, Gs^Fms, Khr, Gs^Fms, Hh^Fms, Hh, Hh, Gg
Gg, Gg, Gg, Gg, Gg, Gg, Wwg, Hh^Fms, Gg, Gg, Gs^Fms, Gg, Hh^Fms, Gs^Fms, Gs^Fms, Hh^Fds, Hh^Fds, Hh^Fp, Gg, Gg, Gg, Gg, Ss, Gg, Ss, Gg, Wwg, Wwg, Ss, Ss, Ss, Wwg, Ss, Gg, Gg, Gs^Fds, Ss, Wwg, Wwg, Gg, Gg, Gs^Fds, Gs^Fds, Chr, Hh, Hh^Fms, Hh^Fms, Hh^Fms, Gs^Fms, Gg
Gg, Gg, Gg, Gg, Gg, Ww, Ww, Ww, Ww, Gg, Gg, Gg, Gg, Gs^Fms, Gg, Gs^Fp, Gg, Gs^Fms, Gs^Fms, Gg, Gg, Gg, Wwg, Wwg, Wwg, Ss, Wwg, Wwg, Gg, Ss, Gg, Ss, Gg, Gg, Gg, Gs^Fds, Gs^Fds, Ss, Gs^Fds, Wwg, Wwg, Gg, Gs^Fds, Gg, Gg, Hh, Hh^Fms, Hh^Fms, Gs^Fms, Gg
Gg, Gg, Gg, Gg, Gg, Ss, Ww, Ww, Ww, Gg, Gg, Gg, Gg, Gs^Vc, Gg, Gg, Gg, Gs^Fms, Gg, Gg, Ss, Ss, Wwg, Wwg, Ss, Wwg, Ss, Gg, Gg^Xo, Gg, Gg, Ss, Gg, Gg, Gs^Fms, Gs^Fms, Gg, Gg, Gg^Xo, Gg, Ss, Wwg, Wwg, Gg, Gs^Fms, Gs^Fms, Gs^Fms, Gg, Gg, Gg
Gg, Gg, Gg, Gg, Gg, Ss, Ww, Ww, Ww, Gg, Gg, Gg, Gg, Gg, Gg, Gs^Fms, Gg, Gg, Gg, Gg, Ss, Wwg, Ww, Ss, Wwg, Wwg, Ss, Gs^Fds, Gg, Gg, Gg, Ss, Gg, Gg, Gg, Gg, Gg, Gg, Gg, Gg, Ss, Ss, Ss, Wwg, Gs^Fms, Gs^Fms, Gg, Gs^Fms, Gg, Gg
Gg, Gg, Gg, Gs^Fms, Gs^Fms, Gg, Gs, Gg, Gs^Fms, Ww, Ww, Gg, Gs^Vc, Gg, Gs^Fms, Gs^Fms, Gg, Gg, Gg, Gg, Gg, Wwg, Ww, Ss, Ss, Ss, Gg, Gg, Gg, Gg, Gg, Gg, Gg, Gg, Gg, Gg, Gg, Gg, Gg, Gg, Gg, Ss, Ss, Wwg, Wwg, Gg^Efm, Gg, Gg, Gg, Gg
Gg, Gg, Gs, Gs^Fds, Hh^Fp, Hh^Fds, Gs, Hh^Fp, Gg, Gg, Ww, Gg, Gg, Gg, Gs^Fms, Gs^Fms, Gg, Gg, Gg, Gg, Gg, Wwg, Wwg, Ss, Gg, Gg, Gg, Gg, Gs^Fms, Gg, Gg, Gg, Gg, Gg^Xo, Gg, Gg, Gg, Gg, Gs^Fds, Gg, Gg, Gg, Gg, Gg, Wwg, Ww, Gg, Gg, Gs^Fms, Gg
Gg, Gg, Gg, Gg, Gg, Gg, Gg, Gg, Ww, Gg, Ww, Ww, Ww, Gs^Fms, Gs^Fms, Gs^Fms, Gg, Gg, Gg, Gg, Ss, Wwg, Wwg, Ss, Gg, Gg^Xo, Gg, Gs^Fms, Gg, Gg, Gg, Gg, Gg, Gg^Xo, Gg, Gg, Gs^Fds, Gs^Fds, Gg, Gg, Gg, Ss^Xo, Gg, Gg, Ww, Ww, Gg, Gg, Gg, Gs^Fms
Gg, Gg, Gg, Gg, Ss, Gg, Gg, Gs^Vc, Gg^Fet, Ww, Ww, Gg, Gg, Ww, Wwf, Gs^Fms, Gg, Gg, Gg^Efm, Gg^Efm, Ss, Wwg, Wwg, Gg, Gs^Fds, Gg, Gg, Gs^Fds, Gg, Gg, Gs^Fds, Gs^Fds, Gg, Gg, Re, Gs^Fms, Gg, Gs^Fds, Gg, Gg, Gg, Gg, Gg, Gg, Ww, Wwg, Gg, Gg, Gg, Gg
Gg, Gg, Gs^Fds, Gg, Gg, Gg, Gg, Gg, Gg, Gg, Wwf, Gg, Gg, Gg, Gg, Wwf, Ww, Gg, Gg, Ss, Ss, Wwg, Wwg, Gs^Fds, Gs^Fds, Ss, Gg, Gg, Gg, Gs^Fds, Gs^Fds, Gg, Gg^Efm, Gg^Efm, Re, Gg, Gg, Gg, Gg, Gg, Gs, Gg, Ss, Ss, Wwg, Wwg, Gg, Gg, Gg, Gs^Fms
Gg, Gs^Fds, Gs^Fds, Gg, Gg, Gg, Gg, Gg, Gg, Ss, Ww, Ss, Gg, Gg, Gg, Gg, Ww, Ss, Gg, Ss, Ss, Wwg, Wwg, Ss, Ss, Ss, Gg, Gg, Gg, Gg, Gs, Gg, Gg, Gg, Gg, Gg, Gg, Gg, Gg, Gg, Gg, Ss, Ss, Wwg, Ss, Ss, Gg, Gg, Gg, Gg
Gg, Gg, Gg, Gg, Gg, Gg, Gg, Gg, Wo, Ss, Wo, Ww, Ww, Gg, Gg, Gg, Ww, Ss, Gg, Gg, Gg, Gg, Gg, Wwg, Wwg, Wwg, Wwg, Gg, Gg^Xo, Gg, Gs^Fds, Gg, Gg, Gg, Gg, Gg, Gg, Gg, Gg^Xo, Gg, Wwg, Ss, Wwg, Wwg, Gg, Gs, Gg, Gg, Gg, Gg
Gg, Gg, Gg, Gg, Gs^Fds, Gg, Gs^Fds, Gg, Ss, Wo, Ww, Wo, Wo, Ww, Ww, Ss, Ww, Ww, Ww, Ss, Ss, Gg, Gg, Gg, Wwg, Ww, Wwg, Ss, Gg, Gs^Fds, Gs^Fms, Gg, Ss, Gg, Re, Gg, Gg, Gg, Gg, Ss, Wwg, Wwg, Gg, Gg, Gg, Gg, Gg, Gg, Gg, Gg
Gg, Gg, Gg, Gs^Fms, Gg, Gg, Gg, Gs^Fds, Gg, Ss, Ss, Gg, Gg, Wo, Gg, Ww, Gg, Ww, Ww, Ww, Ww, Gg, Ss, Ss, Ss, Ww, Wwg, Gg, Gg, Gg, Gg, Gs^Fds, Ss, Ss, Gs^Fds, Gg, Gg, Gg, Gg, Ss, Wwg, Ss, Ss, Gg, Gs, Ss, Ss, Ss, Ss, Gg
Gg, Gs^Fds, Gs^Fds, Gg, Gg, Gg, Gg, Gs^Fds, Gg, Gg, Gg, Gg, Gg, Gg, Gs^Fds, Gs^Fds, Gg, Gg, Ss, Ww, Ww, Gg, Ww, Ww, Ww, Ww, Ww, Ss, Ss^Xo, Re, Gg, Ss, Ww, Ww, Ww, Gs^Fds, Gg, Gg, Gg^Xo, Gg, Wwg, Ss, Ss, Wwg, Ww, Wwg, Ss, Wwg, Wog, Gg
Gg, Gg, Gg, Gg, Gg, Gs^Vc, Gg, Gg, Gs^Fms, Gg, Gg, Gg, Gg, Gg, Gg, Gs^Fds, Gg, Gg, Gs^Fms, Ss, Ss, Ww, Wwg, Ss, Ss, Ww, Ww, Ss, Gg, Gg, Ww, Ww, Gg, Gg, Gg, Ww, Ww, Ss, Ss, Ss, Wwg, Ss, Ww, Wo, Gg, Ww, Ww, Wwg, Ww, Wog
Gg, Gg, Gg, Ww, Wo, Gg, Gg, Gg, Gg, Gg, Gg, Gg, Gs^Fms, Gg, Gg, Gg, Gg, Gs^Fms, Gg, Gg, Gg, Wwg, Wwg, Wwg, Gg, Gg, Gg, Ww, Ww, Ww, Gs^Fms, Gs^Fds, Gg, Gg, Gg, Gg, 1 Re, Ww, Ww, Ww, Ww, Wo, Gs, Gg, Gg, Gg, Gs, Ww, Ss, Ww
Gs^Fds, Gs^Fds, Ww, Wwg, Wwg, Gg, Gs^Fds, Gg, Gs^Fds, Gg^Es, Gg, Gs^Fms, Gs^Fms, Gg, Gg, Gg, Gs^Fds, Gs^Fms, Gs, Gs, Ss, Wwg, Wwg, Gg, Gs^Fms, Gs^Fms, Gs^Fms, Gg, Gg, Gg, Gs^Fms, Gg, Gg, Gg, Gg, Gg, Re, Gg, Gg, Wwg, Gs^Fms, Gg, Gg, Gg, Gg, Gs, Gg, Ss, Ss, Wwg
Gs^Fds, Gs^Fds, Gs^Fms, Ww, Gg, Gs^Fds, Gg, Gg, Gs^Fms, Gg, Gg, Gs^Fms, Gg, Gg, Gs^Fds, Gg, Gg, Gg, Gg, Gg, Gg, Wwg, Wwg, Gg, Gg, Gs^Fms, Gs^Fms, Gg, Gg, Gs^Fds, Gg, Gg, Gg, Gg, Gg, Gg, Gg, Gg, Gg, Gs^Fms, Gs^Fms, Gs^Fds, Gg, Gg, Gg, Gg, Gg, Gg, Gg, Wwg
Gg, Gs^Fms, Gs^Fds, Gs^Fms, Gg, Gg, Gg^Es, Gg, Gg, Gg, Gs^Fms, Gg, Gs^Fds, Hh^Fds, Hh^Fmw, Gg, Hh^Fds, Gs, Gg, Gg, Gg, Gg, Gg, Gg, Gg, Gg, Gg, Gg, Gg, Gg, Gg, Gg, Gs^Fds, Gg, Gg, Gg, Gg, Re, Re, Gg, Gs^Fds, Gg, Gg, Gg, Gg, Gg, Gg, Gg, Gg, Gg
Gg, Gs^Fds, Gg, Gg, Gg, Gg, Gg, Gg, Gg, Gg, Gg, Gg, Gs^Fds, Hh^Fp, Hh^Fmw, Hh^Fp, Hh^Fp, Gs^Fms, Hh^Fms, Gg, Gg, Gg, Gg^Efm, Gs^Vc, Gg, Gg, Gg, Gg, Gg, Gg, Gg, Gg, Gs^Fds, Gg, Gg, Gs^Fms, Gg, Gg, Gg, Re, Gg, Gg, Gg, Gs^Vc, Re, Gg, Gg, Gg, Gg, Gg
Gg, Gg, Gg, Gg, Gg, Gg, Gg, Gg, Gg, Gg, Gs^Fms, Gs^Fms, Gs^Fms, Hh^Fds, Hh^Fp, Hh^Fds, Hh^Fds, Hh^Fds, Hh^Fms, Gg, Gg, Gg, Gg, Gs^Fms, Gg, Gg, Gs^Fms, Gg, Gs^Fds, Gs^Fms, Gg, Gs^Fds, Gg, Gs^Fms, Gg, Gg, Gg, Gg, Gg, Gg, Gg, Re, Re, Re, Gg, Gg, Gg, Gg, Gg, Gg
Gg, Gg, Gg^Es, Gg^Es, Gg^Es, Gg, Gg, Gg, Gg, Gg, Gg, Gg, Gg, Gg, Gs^Fms, Gs^Fms, Gll^Fp, Gs^Fms, Gs^Fms, Gg, Gg, Gg, Gg, Gg, Gg, Gg, Gg, Gg, Gg, Gg, Gg, Gs^Fms, Gg, Gg, Gg, Gg, Gg, Gg, Gs^Fds, Gs^Fms, Gs^Fms, Gs^Fms, Gg, Gg, Gg, Gg, Gg, Gg, Gg, Gg
