border_size=1
usage=map

Gs^Fdw, Gs^Fmw, Gs^Fmw, Gs^Fmw, Gs^Fmw, Gs^Fdw, Gs^Fdw, Gs^Fdw, Gs^Fdw, Gs^Fdw, Gs^Fms, Gg, Gs^Fms, Gs^Fdw, Gs^Fms, Gs^Fdw, Gs^Fms, Gg, Gs^Fms, Gs^Fdw, Gs^Fms, Gs^Fdw, Gs^Fms, Gs^Fdw, Gs^Fp, Gs^Fp, Gs^Fms, Gs^Fdw, Gs^Fmw, Gs^Fdw, Gs^Fp, Gs^Fdw, Gs^Fdw, Gs^Fdw, Gs^Fdw, Gs^Fdw, Gs^Fms, Gs^Fdw, Gs^Fms, Gs^Fms, Gs^Fms, Gs^Fms, Gs^Fms, Gs^Fms, Ha^Fpa, Ha^Fpa
Gs^Fdw, Gs^Fdw, Gs^Fmw, Gs^Fdw, Gs^Fmw, Gs^Fmw, Gs^Fdw, Gs^Fmw, Gs^Fms, Gs^Fms, Gs^Fms, Gs^Fms, Gs^Fms, Gs^Fms, Gs^Fp, Gs^Fmw, Gs^Fp, Gs^Fms, Gs^Fms, Gs^Fms, Gs^Fms, Gs^Fms, Gs^Fmw, Gs^Fms, Gs^Fms, Gs^Fms, Gs^Fms, Gs^Fp, Gs^Fp, Gs^Fdw, Gs^Fp, Gs^Fdw, Gs^Fp, Gs^Fmw, Gs^Fdw, Gs^Fms, Gs^Fms, Gs^Fms, Gs^Fp, Rd, Gs^Fp, Gs^Fms, Gs^Fms, Gs^Fms, Ha^Fpa, Ha^Fpa
Gs^Fdw, Gs^Fmw, Gs^Fdw, Gs^Fdw, Gs^Fp, Gs^Fdw, Gs^Fp, Gs^Fdw, Gs^Fp, Gs^Fp, Gs^Fmw, Gs^Fms, Gs^Fms, Gs^Fms, Gs^Fp, Gs^Fp, Gs^Fp, Gs^Fp, Gs^Fmw, Gs^Fms, Gs^Fp, Gs^Fp, Gg, Gs^Fp, Gg, Gs^Fp, Ke, Gs^Fms, Gs^Fp, Gs^Fp, Gs^Fp, Gs^Fp, Gs^Fp, Gs^Fp, Gs^Fp, Rd, Gs^Fp, Gs^Fms, Gs^Fms, Gs^Fp, Gs^Fp, Gs^Fp, Ha^Fpa, Ha^Fpa, Ha^Fpa, Ha^Fpa
Gs^Fp, Gs^Fdw, Gs^Fmw, Gs^Fdw, Gs^Fp, Gs^Fp, Gg, Gs^Fp, Gs^Fms, Gs^Fp, Gs^Fp, Gg, Gg, Gs^Fp, Gs^Fp, Gs^Fp, Gs^Fp, Gs^Fp, Gs^Fp, Gs^Fms, Gs^Fp, Gs^Fp, Gs^Fp, Gs^Fp, Gs^Fp, Ce, Ce, Ce, Gs^Fp, Gs^Fp, Gs^Fms, Gs^Fp, Gg, Gs^Fms, Gs^Fp, Gs^Fp, Gs^Fp, Gs^Fms, Gs^Fp, Gs^Fp, Gs^Fp, Ha^Fpa, Ha^Fpa, Ha^Fpa, Ms, Ha^Fpa
Gs^Fp, Gs^Fp, Gs^Fp, Gs^Fp, Gg, Gs^Fp, Gs^Fp, Gs^Fp, Gs^Fp, Gs^Fp, Gs^Fp, Gg, Gs^Fp, Gs^Fp, Gs^Fp, Gs^Fp, Gs^Fp, Gs^Fp, Gs^Fp, Gs^Fms, Gg, Gll^Fp, Gs^Fp, Gs^Fp, Gs^Fp, Gg, Gs^Fp, Gs^Fp, Gs^Fp, Gs^Fp, Gs^Fp, Gs^Fp, Gs^Fp, Gs^Fp, Gs^Fp, Gs^Fp, Ha^Fpa, Gs^Fp, Gs^Fp, Gs^Fp, Ha^Fpa, Ha^Fpa, Ms, Ms, Ms, Ms
Gs^Fp, Gs^Fp, Gs^Fp, Gs^Fp, Gs^Fp, Gs^Fp, Gs^Fp, Gs^Fms, Gs^Fms, Gs^Fp, Gg, Gg, Gg, Gs^Fp, Gs^Fp, Gs^Fp, Gs^Fp, Gs^Fp, Gs^Fp, Gs^Fp, Gg, Gs^Fms, Gs^Fp, Gll^Fp, Gs^Fp, Gs^Fp, Gs^Fp, Gs^Fp, Gs^Fp, Gs^Fp, Gll^Fp, Gs^Fp, Ha^Fpa, Ha^Fpa, Ha, Ha^Fpa, Ha^Fpa, Gll^Fp, Aa^Fma, Gll^Fp, Aa^Fma, Ms, Ha^Fpa, Aa^Fpa, Aa^Fpa, Ms
Gs^Fp, Gs^Fp, Gs^Fp, Gs^Fp, Gs^Fp, Gs^Fp, Gs^Fp, Gs^Fp, Gs^Fp, Gs^Fp, Gg, Gg, Gg, Gs^Fp, Gs^Fp, Gs^Fp, Gs^Fp, Gs^Fp, Aa^Fpa, Gg, Gg, Gs^Fp, Gs^Fp, Gs^Fp, Gs^Fp, Gs^Fp, Gs^Fp, Gs^Fp, Gs^Fp, Gll^Fp, Aa^Fma, Ha^Fpa, Ha, Ha, Ms, Ha, Aa^Fma, Aa^Fma, Ms, Aa^Fma, Aa^Fma, Ms, Ha^Fpa, Ha^Fpa, Ww, Ww
Aa^Fpa, Gs^Fp, Aa^Fpa, Aa^Fpa, Aa^Fpa, Gs^Fp, Gs^Fp, Gs^Fp, Gs^Fp, Gg, Gg, Gg, Gs^Fp, Gs^Fp, Ha^Fda, Ha^Fda, Ha^Fpa, Ha^Fpa, Ha^Fpa, Aa^Fpa, Aa^Fma, Gg, Gg, Gg, Gs^Fms, Gs^Fp, Gll^Fp, Gs^Fp, Hh^Fds, Gll^Fp, Aa^Fpa, Ha, Ha, Ms, Ms, Ms, Ms, Aa^Fma, Ms, Ms, Ms, Aa^Fpa, Ww, Ww, Ha^Fpa, Ha^Fpa
Ha, Aa^Fpa, Ha, Aa^Fpa, Ha, Aa^Fpa, Aa^Fpa, Gs^Fp, Gs^Fp, Gg, Gg, Gg, Ha, Ha^Fda, Ms, Aa^Fpa, Ms, Ha^Fpa, Ha^Fpa, Ha, Ha^Fpa, Aa, Gg, Gg, Hh^Fdw, Gs^Fp, Gs^Fp, Gs^Fp, Hh^Fms, Gg, Aa^Fpa, Ha, Ms, Ms, Ms, Ms, Ms, Ms, Ms, Ms, Ww, Ww, Ms, Ms, Ms, Ha^Fpa
Ha, Ha, Ms, Ha, Ms, Ha, Aa, Gs^Fp, Gs^Fp, Gg, Gg, Gg, Aa^Fpa, Ha, Ms, Ms, Ms, Ms, Ms, Ha, Ha^Fpa, Aa^Fma, Gg, Gs^Fms, Hh^Fms, Hh^Fp, Hh^Fdw, Hh^Fds, Hh^Fms, Hh, Hh^Fms, Ha^Fma, Wo, Ms, Ms, Ms, Ms, Ms, Ms, Ms, Ww, Ms, Ms, Ms, Aa^Fma, Ha
Ha, Ha, Ms, Ms, Ms, Ms, Aa, Aa^Fpa, Gg, Gg, Gs^Fp, Hh, Ha, Ms, Ha, Ha, Ms, Ha, Ha, Ha, Ha, Aa^Fda, Gg, Gg, Gg, Hh^Fdw, Hh, Hh, Hh, Hh^Fds, Hh, Hh^Fms, Wo, Wo, Ha^Fma, Ms, Ms, Ms, Ms, Ww, Ms, Ms, Ms, Aa^Fma, Ha, Ms
Ha, Ha, Ms, Ms, Ms, Ms, Ha^Fpa, Ha^Fpa, Gg, Gg, Gs^Fp, Hh, Ha, Ms, Ms, Ms, Ha, Ms, Ha, Ha, Ha, Gg, Gg, Gg, Gg, Hh^Fmw, Hh, Hh^Vhh, Gg, Ww, Ww, Ww^Es, Ww, Hh^Fmw, Hh^Fmw, Ms, Ha, Ha, Ha, Ww, Ww, Ms, Ha^Fpa, Ha, Ha, Ha
Aa, Ms, Ms, Ms, Ha, Ha, Ha^Fpa, Gg, Gd^Fetd, Gs^Fp, Gs^Fp, Hh^Fmw, Ha, Ha, Ha, Ha, Ha, Ha, Ha, Ha, Ha, Gg, Gs^Fp, Gg, Gg, Gg, Gg, Gg, Gg, Ww, Gg, Ww, Gs^Fp, Hh, Hh^Fmw, Hh^Fmw, Gs^Fp, Ha, Hh, Ha^Fma, Ww^Es, Ha^Fpa, Ha, Ha^Fpa, Ha^Fpa, Ha
Aa, Ha, Ha, Ha, Ha^Fpa, Ha^Fpa, Gg, Gg, Gll^Fp, Gll^Fp, Hh, Hh^Fmw, Hh^Fmw, Ha, Hh, Ha, Hh^Fmw, Hh^Fmw, Hh^Fmw, Ha, Gg, Gg, Hh^Fp, Hh^Fmw, Hh, Gs^Fms, Gg, Gg, Gg, Gg, Gs^Fms, Gs^Fms, Hh^Fds, Gs^Fp, Gs^Fp, Hh^Fmw, Hh, Gs^Fp, Gs^Fp, Ha^Fma, Ww, Ha^Fpa, Ww, Gs^Fp, Gs^Fp, Gs^Fp
Gg, Aa, Aa, Aa, Gg, Gg, Gs^Fp, Gs^Fp, Gs^Fms, Gs^Fms, Gs^Fds, Hh, Hh, Hh^Fmw, Gs^Fms, Hh, Gg, Hh, Gg, Gg, Hh^Fp, Hh^Fp, Hh^Fp, Hh^Fmw, Hh, Gg, Gg, Gg, Gg, Gg, Gg, Gg, Gs^Fms, Gs^Fp, Hh^Fds, Hh, Hh, Hh, Hh, Gs^Fp, Ww, Ww, Ww, Gs^Fp, Gs^Fp, Gs^Fp
Gg, Gg, Gg, Gg, Gg, Gg, Gs^Fp, Gs^Fp, Gs^Fds, Gs^Fms, Gs^Fms, Gs^Fds, Gs^Fds, Gs^Fds, Gg, Gs^Fds, Gg, Gg, Gg, Gs^Fp, Hh^Fp, Hh^Fmw, Hh^Fmw, Hh^Fmw, Hh^Fmw, Gs^Fms, Hh^Fmw, Gg, Gg, Gg, Gg, Gs^Fms, Hh^Fds, Gs^Fms, Hh^Fdw, Hh^Fds, Gg, Gs^Fp, Hh^Vhh, Hh, Ww, Ww, Gs^Fp, Gs^Fp, Gs^Fp, Gs^Fp
Gs^Fp, Gg, Gg, Gg, Gg, Gg, Gg, Gs^Fds, Gg, Gg^Vh, Gg, Gg, Gg, Gg, Gg, Gg, Gg, Hh^Fp, Hh^Fp, Hh^Fp, Hh^Fms, Hh^Fp, Hh^Fp, Hh^Fmw, Hh^Fms, Hh^Fmw, Hh^Fmw, Hh^Fmw, Hh^Fmw, Hh^Fmw, Gg, Hh, Hh^Fds, Hh^Fds, Gg, Gg, 1 Gg, Gg, 2 Gg, Gg, Hh^Fms, Ww, Ww^Es, Gs^Fp, Gs^Fp, Gs^Fp
Gs^Fp, Gs^Fp, Gs^Fp, Gg, Gg, Gg, Re, Gg, Gg, Gg, Gs^Fp, Gg, Gs^Fp, Gg, Gg, Gg, Gs^Fp, Gs^Fp, Gs^Fp, Hh^Fms, Hh^Fms, Hh^Fmw, Hh^Fp, Hh^Fp, Hh^Fmw, Hh^Fms, Hh^Fms, Hh^Fms, Hh^Fms, Hh^Fms, Gg, Gg, Gg, Gg, Gg, Gg, Hh^Fmw, Gg, Gs^Fms, Hh^Fmw, Hh^Fmw, Hh^Fmw, Hh^Fmw, Ww^Es, Ww, Gs^Fp
Ha^Fma, Gs^Fp, Aa^Fda, Gs^Fp, Hh^Fp, Gg, Hh^Fms, Gg, Re, Gs^Fp, Hh^Fms, Gs^Fp, Gs^Fp, Gs^Fp, Gg, Gg, Gs^Fp, Gs^Fp, Hh^Fms, Hh^Fms, Hh^Fmw, Hh^Fmw, Hh^Fms, Hh^Fms, Hh^Fmw, Hh^Fmw, Hh^Fms, Hh^Fms, Hh^Fms, Hh^Fms, Hh^Fms, Gg, Gg, Gs^Fms, Hh, Hh^Fms, Hh^Fms, Gs^Fms, Gs^Fms, Hh^Fms, Hh^Fms, Hh^Fmw, Hh^Fms, Hh^Fms, Hh^Fms, Ww
Ms, Ha, Ha, Gs^Fms, Aa^Fda, Gs^Fp, Hh^Fp, Hh^Fms, Gg, Re, Hh^Fms, Hh^Fms, Gs^Fp, Gg, Gs^Fp, Gs^Fp, Gs^Fp, Hh^Fms, Hh^Fms, Hh^Fms, Hh^Fms, Hh^Fms, Hh^Fms, Hh^Fms, Hh^Fms, Hh^Fmw, Hh, Hh^Fms, Gs^Fp, Gs^Fp, Hh^Fms, Hh^Fms, Gg, Gs^Fp, Gs^Fp, Hh^Fms, Hh^Fms, Hh, Hh^Fms, Hh^Fms, Gg, Gg, Gg, Hh^Fms, Gs^Fms, Gs^Fmw
Ha^Fma, Ms, Ms, Ha^Fma, Ha^Fma, Hh^Fms, Hh^Fp, Gg, Gg, Re, Gs^Fp, Gs^Fp, Gg, Gg, Gs^Fp, Gs^Fp, Gs^Fp, Hh^Fms, Hh^Fms, Hh^Fms, Gs^Fp, Gs^Fp, Gs^Fp, Hh^Fms, Hh^Fms, Hh^Fms, Hh, Gs^Fp, Gs^Fp, Gs^Fp, Hh^Vhh, Hh, Hh^Fms, Gg, Hh^Fms, Gs^Fp, Gs^Fp, Hh, Hh^Fms, Gg, Gg, Gg, Gg, Gs^Fms, Gg, Gg
Ms, Ha^Fma, Ha, Ms, Gs^Fms, Gs^Fp, Gg, Ce, Ce, Gg, Gg, Gg, Gg, Gs^Fp, Gs^Fp, Gs^Fp, Gs^Fp, Gs^Fp, Hh^Fmw, Hh^Fms, Hh^Fms, Gs^Fp, Gs^Fp, Hh^Fms, Gs^Fp, Hh^Fms, Gs^Fp, Hh^Fms, Gs^Fp, Gs^Fp, Gs^Fp, Hh^Fms, Gs^Fp, Gg, Hh^Fms, Gs^Fp, Gs^Fp, Hh^Fms, Hh, Hh^Fms, Gg, Gg, Gg, Gg, Gg, Gg
Ms, Ha^Fda, Ms, Ms, Ha^Fma, Gs^Fp, Gs^Fp, Ke, Ce, Gg, Re, Gg, Gg, Gs^Fp, Gs^Fp, Gs^Fp, Gs^Fp, Gs^Fp, Hh^Fmw, Hh^Fms, Hh^Fms, Hh^Fmw, Gs^Fp, Gs^Fp, Gg, Gs^Fp, Gs^Fp, Gs^Fp, Gs^Fp, Gs^Fp, Gs^Fp, Gs^Fp, Gg, Gg, Gs^Fms, Gs^Fp, Gs^Fp, Hh^Fms, Gs^Fp, Hh^Fms, Gg, Gg, Gg, Gg, Gg, Gg
Ha^Fda, Ms, Ms, Ha^Fda, Gs^Fms, Gs^Fp, Hh^Fp, Hh, Gg, Gg, Re, Gg, Gs^Fp, Gs^Fp, Gs^Fp, Gs^Fp, Gs^Fp, Hh^Fmw, Hh^Fmw, Hh^Fmw, Hh^Fmw, Hh^Fmw, Hh^Fmw, Gs^Fp, Gg, Gg, Gs^Fp, Gs^Fp, Gg, Gs^Fp, Gs^Fp, Gs^Fms, Gg, Gg, Gs^Fp, Gs^Fp, Gs^Fms, Gs^Fp, Gg, Gs^Fp, Gg, Gg, Gg, Gs^Fms, Gs^Fms, Gg
Gs^Fms, Aa^Fda, Gs^Fp, Ha^Fda, Gs^Fp, Gs^Fp, Hh^Fp, Hh, Gs^Fp, Gg, Re, Gg, Gg, Gs^Fp, Gs^Fp, Gs^Fp, Gs^Fp, Gs^Fp, Gs^Fp, Hh^Fmw, Hh^Fmw, Hh^Fmw, Gs^Fp, Gs^Fp, Gg, Gg, Gg, Gg, Gg, Gg, Gg, Gg, Gg, Gg, Gg, Gs^Fp, Gg, Gg, Gg, Gg, Gg, Gg, Gg, Gs^Fms, Gg, Gg
Gs^Fp, Gs^Fp, Gs^Fp, Gs^Fp, Gs^Fp, Hh^Fdw, Gs^Fp, Gs^Fp, Gs^Fp, Gg, Gg, Re, Re, Gg, Gg, Gg^Vh, Gg, Gs^Fp, Gg, Gs^Fp, Gg, Gs^Fp, Gg, Gg, Gg, Gg, Gg, Gg, Gg, Gg, Gg, Gg, Gg, Gg, Gg, Gg, Gg, Gg, Gg, Gg, Gg, Gs^Fms, Gs^Fms, Gg, Gg, Gg
Gs^Fp, Gs^Fp, Hh^Fdw, Hh^Fdw, Hh^Fp, Hh^Fdw, Gs^Fp, Gs^Fp, Gs^Fp, Gg, Gg, Gg, Gg, Gg, Re, Gg, Re, Gg, Re, Gg, Gg, Re, Gg, Re, Re, Gg^Efm, Gg^Efm, Gg, Re, Gg^Vh, Re, Gg, Gg, Gg^Efm, Gg^Vh, Gg, Re, Re, Re, Gg, Gg, Gg, Gs^Fms, Gg, Gg, Gg
Gs^Fp, Hh^Fdw, Hh^Fp, Hh^Fp, Hh^Fp, Gs^Fp, Gs^Fp, Gs^Fp, Gg, Gg, Gg, Gg, Gg, Gg, Gg, Re, Gg, Gg, Gg, Gg, Gs^Fmw, Gg, Gs^Fp, Gg, Gg, Re, Re, Re, Re, Re, Re, Re, Re, Re, Gg, Gg, Gs^Fmw, Gg, Gg, Gg, Re, Gg, Gg, Gg, Gg, Gg
Hh^Fp, Hh^Fdw, Hh^Fp, Hh^Fp, Hh^Fp, Hh^Fp, Gs^Fp, Gg^Vh, Gg, Gg, Gg, Gg, Gg, Gg, Gg, Gg, Gg, Gs^Fp, Gs^Fdw, Gs^Fmw, Gs^Fmw, Gs^Fp, Gs^Fp, Gs^Fp, Gg, Gg^Vh, Re, Re, Gg^Fet, Gg^Efm, Re, Re, Gg^Vh, Gg, Gg, Gs^Fmw, Gs^Fmw, Gs^Fmw, Gs^Fmw, Gg, Gg, Gg, Re, Gg, Gg, Gg
Hh^Fp, Hh^Fdw, Ww, Hh^Fp, Ww, Hh^Fp, Hh^Fp, Gg, Hh^Fp, Gll^Fp, Gll^Fp, Gg, Gg, Gg, Gg, Gg, Hh^Fp, Gs^Fp, Gs^Fp, Gs^Fmw, Gs^Fmw, Gs^Fmw, Ww, Gg, Gg, Gg, Gg, Re, Re, Re, Re, Re, Gg, Gg, Ch, Ch, Ww, Gg, Gs^Fmw, Gg, Ww, Gg, Gg, Re, Gg, Gg
Hh^Fp, Hh^Fp, Ww, Ww, Ww, Hh^Fp, Hh^Fp, Hh^Fp, Gs^Fp, Hh^Fp, Gg, Gg, Gg, Gg, Gg, Gg, Hh^Fp, Hh^Fp, Gs^Fp, Gs^Fmw, Ww, Ww, Ww, Ww, Gg, Gg, Re, Re, Gg, Gg, Gg, Gg, Gg, Gg, Ww, Kh, Ww, Ww, Ww, Ww, Ww, Gg, Gg, Re, Gg, Gg
Hh^Fp, Hh^Fp, Ww, Ww^Es, Md, Hh^Fp, Hh^Fp, Hh^Fp, Gs^Fp, Gs^Fp, Gg, Gg, Gg, Gg, Gg, Gg, Hh^Fp, Hh^Fp, Ww^Es, Ww, Gg^Efm, Gg^Efm, Gg, Ww, Ww^Bw/, Re, Gg, Gg, Gg, Gg, Ww, Ww, Ww, Ww, Gg, Ww, Gg, Gg, Gg, Ww, Gg, Ww, Ww^Bw/, Re, Gg, Gg
Hh^Fp, Hh^Fp, Hh^Fp, Ww, Md, Hh^Fp, Gs^Fp, Gs^Fp, Gs^Fp, Gs^Fp, Gs^Fp, Gg, Gg, Gg, Gg, Gg, Ww, Ww^Es, Gg, Gg, Gg, Gg, Gg, Re, Gg, Ww, Ww, Ww, Ww^Es, Ww, Gg^Efm, Gg^Fet, Gg, Gg, Gs^Vh, Gg, Gg, Gg^Vh, Gg, Gg, Gg, Re, Gg^Efm, Ww, Ww, Gg
Hh^Fp, Hh^Fp, Hh^Fp, Hh^Fp, Hh^Fp, Hh^Fp, Gs^Fp, Gs^Fp, Gs^Fp, Gll^Fp, Gs^Fp, Gs^Fp, Gs^Fp, Gg, Gg, Gg^Efm, Ww, Gg, Gg, Gg, Gg, Gg, Gg, Re, Gg, Gg, Gg, Ww, Gg, Gg, Gg, Gg, Gg, Gg, Gg, Gg, Gg, Gg, Gg, Re, Gg, Gg, Gg^Efm, Gg, Gg, Ww
Hh^Fp, Hh^Fp, Hh^Fp, Hh^Fp, Hh^Fp, Hh^Fp, Gs^Fp, Gs^Fp, Gs^Fp, Gs^Fp, Gs^Fp, Gs^Fp, Gs^Fp, Gg, Gg, Ww, Gg, Gg, Gg, Gg, Gg, Gg, Gg, Re, Gg, Gg, Gg, Gg, Gg, Gg, Gg, Gg, Gg, Gg, Gg, Gg, Gg, Gg, Gg, Gg, Gg, Gg, Gg, Gg, Gg, Gg