border_size=1
usage=map

Gg, Gg, Gg, Gg, Gg, Gg, Gg, Re, Gg, Gg, Gg, Ww, Gg, Gg, Gg, Gg, Gg, Gg, Gg, Gg, Gg, Gg, Gg, Gg, Gg, Gg, Gg, Gg, Gg, Gg, Gg, Gg, Gg, Gg, Gg, Gg, Gg, Gg, Gg, Gg, Gg, Gg, Gg, Gg, Gg, Gg, Gg, Ww, Gg, Gg, Re, Gs^Fds, Gs^Fds, Gs^Fds, Gg, Hh, Hh, Hh, Hh, Hh, Hh, Gg, Gg, Gg, Mm, Gg, Mm, Mm^Xm, Mm, Mm, Mm, Mm, Mm
Gg, Gg, Gg, Gg, Gg, Gg, Gg, Re, Gg, Gg, Gg, Ww, Ww, Gg, Gg, Gg, Gs^Fds, Gg, Gg, Gg, Gg, Gg, Gg, Gg, Gg, Gg, Gg, Gg, Gg, Gg, Gg, Gg, Gg, Gg, Gg, Gg, Gg, Gg, Hh^Fms, Gg, Hh^Fds, Gg, Gs^Fms, Gg, Gg, Gg, Ww, Ww, Gg, Gs^Fds, Re, Gs^Fds, Gg, Gg, Gs^Fds, Hh^Fms, Hh^Fms, Hh^Fms, Hh, Hh, Hh, Hh, Hh, Mm, Mm, Mm, Mm^Xm, Mm^Xm, Mm, Mm, Mm, Mm, Mm
Gg, Gg, Gg, Gg, Gs^Fds, Gg, Gg, Re, Gg, Gg, Gs^Fms, Gs^Fms, Gg, Ww, Ww, Gs^Fms, Gg, Gg, Gg, Gg, Gg, Gg, Gg, Gg, Gg, Gg, Gs^Fds, Gg, Gg, Gg, Gg, Gg, Gg, Gg, Gg, Gg, Gs^Fds, Hh^Fms, Gs^Fms, Hh^Fds, Gs^Fms, Hh^Fms, Gs^Fds, Gs^Fms, Ww, Ww, Gs^Fds, Gg, Gg, Gg, Re, Gg, Gg, Gs^Fds, Gg, Hh, Hh, Hh^Fms, Hh, Hh, Hh^Fms, Hh, Mm, Mm, Mm, Mm, Mm^Xm, Mm, Mm, Mm, Mm, Mm, Hh
Gg, Gg, Gs^Fms, Gs^Fds, Gg, Gs^Fds, Gg, Re, Gg, Gg, Gg, Gg, Gs^Fms, Hh^Fds, Ww, Hh^Fds, Hh^Fds, Hh^Fds, Hh^Fds, Gg, Hh^Fds, Gs^Fds, Gg, Gg, Gg, Gs^Fds, Gg, Gs^Fds, Gg, Gg, Gg, Gg, Gg, Gg, Gg, Gg, Gg, Gs^Fds, Gg, Hh^Fms, Gs^Fms, Hh^Fms, Gg, Gg, Ww, Gs^Fms, Gg, Gg, Re, Re, Gs^Fds, Gs^Fds, Gs^Fds, Gg, Hh, Hh, Hh^Fms, Hh^Fms, Gs^Fds, Gs^Fds, Gs^Fms, Mm, Mm, Mm, Mm, Mm^Xm, Mm, Mm, Hh, Hh, Hh, Hh, Hh
Gg, Gg, Gs^Fds, Gg, Gs^Fds, Gs^Fds, Gg, Re, Gs^Fms, Gs^Fms, Gg, Gg, Gs^Fms, Gg, Ww, Gs^Fms, Gg, Gg, Hh^Fds, Hh^Fds, Hh^Fds, Gg, Hh^Fds, Gg, Gg, Gg, Gg, Gg, Gg, Gg, Gg, Gg, Gg, Gg, Gg, Gs^Vh, Gg, Gg, Gg, Gg, Gg, Gg, Gg, Gg, Ww, Gg, Gg, Gg, Re, Gg, Gg, Gs^Fds, Hh^Fds, Hh, Mm, Mm, Hh^Fds, Hh, Gs^Fds, Hh, Mm, Gs^Fds, Gs^Fms, Gs^Fds, Gs^Fds, Mm^Xm, Chr, Khr, Khr, Mm, Mm, Hh, Mm
Gg, Gs^Fds, Gg, Gs^Fds, Gs^Fms, Gg, Gg, Re, Gs^Fms, Gg, Gg, Hh^Fms, Gg, Gg, Ww, Gg, Gg, Gs^Fms, Gs^Fms, Gg, Gs^Fds, Hh^Fds, Gs^Fds, Gs^Fds, Gg, Gg, Gg, Gg, Gg, Gg, Gs^Fds, Gg, Gg, Gg, Gg, Gg, Gg, Gs^Fds, Gg, Gg, Ww, Ww, Ww, Ww, Ww, Ww, Gs^Fds, Gs^Fds, Re, Gg, Gs^Fds, Gs^Fds, Mm, Hh^Fms, Mm, Mm, Gg, Gg, Gs^Fms, Mm, Mm, Mm, Mm, Mm, Hh^Fms, Hh, Hh, Chr, Mm, Mm, Mm^Xm, Mm, Mm
Gg, Gg, Gg, Gs^Fds, Gg, Gg, Gg, Re, Gg, Gg, Gs^Fms, Hh^Fms, Gg, Gg, Ww, Gg, Gg, Gg, Hh^Fds, Hh^Fds, Hh^Fds, Gg, Hh^Fds, Hh^Fds, Gg, Gg, Gs^Fds, Hh^Fds, Hh^Fds, Gs^Fds, Hh^Fds, Gg, Gg, Gs^Fms, Gs^Fms, Gg, Gs^Fms, Gs^Fds, Ww, Ww, Ss, Ss, Ss, Gs^Fds, Gs^Fds, Ww, Gs^Fds, Gg, Re, Gg, Gs^Fds, Hh^Fds, Mm, Mm, Hh, Hh^Fms, Gg, Hh^Fds, Mm, Mm, Mm, Mm, Hh, Hh, Gs^Fms, Hh, Mm, Mm^Xm, Mm^Xm, Mm^Xm, Mm, Mm^Xm, Mm
Gg, Gg, Gg, Gg, Gg, Gg, Gg, Re, Gg, Gg, Gs^Fms, Gs^Fms, Gg, Gs^Fms, Gs^Fms, Ww, Ww, Gs^Fms, Gs^Fms, Gg, Gs^Fds, Hh^Fds, Gs^Fds, Gs^Fds, Gg, Gg, Gs^Fds, Hh^Fds, Hh^Fds, Hh^Fds, Gg, Gg, Gg, Gg, Gs^Vh, Gs^Fms, Gg, Gg, Ww, Ww, Ss, Gs, Gs, Gs^Fds, Gs^Fds, Wwt, Gg, Gs, Re, Gs^Fds, Gg, Hh^Fms, Hh^Fms, Hh^Fms, Gg, Gg, Hh^Fms, Hh, Mm, Hh^Fms, Hh^Fms, Gs^Fds, Gg, Gs^Fds, Mm, Mm, Mm, Mm^Xm, Mm, Mm, Mm, Mm^Xm, Mm^Xm
Gg, Gg, Ww^Ewl, Gs^Fds, Gs^Fds, Gs^Fds, Gg, Re, Gg, Gs^Fms, Gs^Fms, Gg, Gs^Fms, Gs^Fms, Gg, Gg, Hh^Fms, Ww, Ww, Hh^Fds, Ww, Gs^Fms, Gs^Fms, Hh^Fds, Gg, Gg, Gs^Fds, Gs^Fds, Gg, Gg, Gg, Gg, Gg, Gg, Gg, Gg, Gs^Fms, Gg, Ww, Ss, Ss, Gg, Ss, Gg, Wwt, Wwt, Gg, Gg, Re, Gs^Fds, Hh, Gs^Fms, Gs^Fms, Hh, Gg, Gg, Gg, Hh^Fms, Hh^Fms, Gs^Fds, Gg, Gs, Hh, Hh, Mm, Mm, Mm, Mm, Mm, Mm, Mm, Mm, Mm
Gg, Ww, Ww^Ewf, Gs^Fms, Gg, Gs, Re, Re, Gs, Gs, Gg, Gg, Gs^Fms, Gs^Fms, Gg, Gg, Hh^Fms, Ww, Ww, Ww, Hh^Fms, Ww, Ww, Gs^Fms, Gs^Vh, Gg, Gs^Fds, Gg, Gg, Gg, Gg, Gg, Gg, Gg, Gs^Fds, Gs^Fds, Gs^Fms, Ss, Ww, Ss, Ss, Wwt, Wwt, Wwt, Wwt, Gg, Re, Re, Gs^Fds, Hh^Fms, Hh^Fms, Gs^Fms, Gg, Gg, Gs^Fms, Gs^Fms, Gs^Fds, Gg, Gg, Gg, Gg, Hh, Mm, Mm, Mm, Mm, Hh, Hh, Hh, Hh^Fms, Mm^Xm, Mm^Xm, Mm
Gg, Gg, Gg^Eff, Gg^Eff, Gg^Eff, Gs^Vh, Gg, Re, Gg, Gg, Gs^Fds, Gg, Gs^Fds, Gg, Gg, Gs^Fms, Gs^Fms, Gs^Fms, Ww, Ww, Ww, Ww, Ww, Gs^Fms, Gg, Gg, Gs^Fds, Gg, Gg, Gg, Gg, Gg, Gg, Gs^Fds, Gs^Fds, Gs^Fds, Gs^Fds, Ss, Ww, Ss, Ww, Wwt, Ss, Ss, Gs, Gg, Re, Gs^Fds, Gg, Hh, Hh^Fms, Hh, Gg, Hh, Hh, Hh^Fms, Hh, Gg, Gg, Hh, Hh^Fms, Hh, Hh^Fms, Hh^Fms, Hh^Fms, Hh^Fms, Hh, Hh, Hh, Mm, Mm, Mm^Xm, Mm
Gg^Eff, Gg^Eff, Gg^Gvs, Gs^Gvs, Gg^Gvs, Gg^Eff, Gg^Eff, Re, Gg, Gg, Gs^Fds, Gg, Gg, Gg, Gg, Gg, Gg, Gg, Hh^Fms, Ww, Ww, Ww, Ww, Gg, Gs^Fds, Gg, Gg, Gg, Gg, Gg, Gg, Gg, Gg, Gg, Gg, Gs^Fds, Gs^Fds, Gg, Gs^Fms, Ww, Ww, Wo, Gg, Gs, Gg, Gg, Re, Gg, Gg, Gs^Fds, Gg, Gg, Hh^Fms, Hh, Hh^Fms, Hh, Hh, Gg, Gg, Gg, Gg, Hh^Fms, Hh, Hh^Fms, Mm, Mm, Mm, Hh, Hh^Fms, Mm, Mm, Mm^Xm, Mm
Gg^Gvs, Gg^Gvs, Gg^Gvs, Gs^Gvs, Gg^Eff, Gg^Eff, Gg, Re, Gg, Gs, Gg^Fet, Gs^Fds, Gs^Fds, Gg, Gs^Eff, Gg, Gg, Gs^Fms, Hh^Fms, Hh^Fms, Gs^Fms, Hh^Fms, Wwg, Gg, Gs^Fds, Gs^Fds, Gs^Fds, Gg, Gs^Fds, Gg, Gg, Gg, Gg, Gg, Gs^Fds, Gs^Fds, Gs^Fms, Gs^Fds, Gs^Fds, Gs^Fms, Ww, Gs^Fms, Gs^Fds, Gg, Gg, Gg, Re, Gg, Gg, Gg, Hh^Fds, Gs^Fms, Mm, Hh, Mm, Hh, Hh, Hh, Gg, Gg, Gg, Hh, Hh, Hh, Mm, Mm, Mm, Hh^Fms, Hh^Fms, Mm, Mm, Mm, Mm
Gg^Gvs, Gg^Gvs, Gg^Eff, Gg^Eff, Gg, Gg, Gg, Re, Re, Gg, Gs^Vh, Gg, Gg^Eff, Gg^Eff, Gg^Gvs, Gg^Eff, Gg^Eff, Gg, Gs^Fds, Gs^Fms, Gg, Gs^Fds, Gg, Wwg, Wwg, Gg, Gs^Fds, Gg, Gs^Fds, Gs^Fds, Gg, Gg, Gs^Fms, Gs^Fds, Gs^Fds, Gs^Fms, Gs^Fms, Gs^Fds, Gs^Fds, Gs^Fds, Ww, Gs^Fds, Gs^Fds, Gg, Gg, Gg, Re, Gs^Fds, Gs^Fds, Gg, Hh^Fms, Hh^Fms, Hh, Mm, Hh, Mm, Mm, Hh^Fms, Gs^Fds, Gs^Fds, Gg, Hh, Hh, Hh, Mm, Mm, Hh, Hh, Hh, Mm, Mm, Mm, Gg
Gg, Gg^Eff, Gg, Gg, Gg, Gg, Gg, Re, Gg, Gg, Gg^Eff, Gg^Eff, Gg^Gvs, Gg^Gvs, Gg^Gvs, Gg^Gvs, Gg^Gvs, Gs^Eff, Gg^Eff, Gg, Gg, Gg, Gg, Gg, Wwg, Gs^Fds, Ss, Gg, Ww, Gg, Gg, Gs^Fms, Gs^Fds, Gs^Fds, Gs^Fms, Gg, Gs^Fds, Gg, Gg, Gs^Fds, Ww, Gs^Fds, Gg, Gg, Re, Re, Gg, Gg, Gg, Hh, Hh, Hh^Fms, Gg, Hh, Hh, Mm, Mm, Hh^Fms, Hh^Fms, Gg, Gg, Gg, Gg, Mm, Mm, Mm, Hh, Hh, Hh, Hh^Fms, Hh, Hh, Hh
Gg, Gg, Gg, Gg, Gg, Gg, Gg, Re, Gg^Eff, Gg^Eff, Gg^Gvs, Gg^Gvs, Gg^Gvs, Gg^Gvs, Gg^Gvs, Gg^Gvs, Gg^Eff, Gg^Eff, Gg, Gg, Gs^Fds, Gg, Gs^Fds, Gg, Ww, Ss, Ww, Ww, Gg, Ww, Ww, Gs^Fds, Gg, Gs^Fds, Gg, Gs^Fms, Gg, Gg, Ss, Gg, Ww, Gg, Re, Re, Gg, Gs^Vh, Gg, Gs^Fds, Gs^Fds, Hh, Hh, Hh^Fms, Gg, Gg, Gg, Hh^Fms, Mm, Hh^Fms, Hh, Hh, Hh, Gg, Gg, Mm, Hh, Mm, Hh^Fms, Hh^Fms, Hh, Hh^Fms, Hh, Hh, Hh
Gg, Gs^Fds, Gg, Gs^Fds, Gg, Gs^Fds, Gg, Re, Gg, Gg^Eff, Gs^Eff, Gg^Gvs, Gg^Gvs, Gg^Gvs, Gg^Eff, Gg^Eff, Gg, Gg, Gg, Gg, Gs^Fds, Gg, Gs^Fds, Gg, Gs^Fds, Ww, Ww, Ww, Ww, Ww, Ww, Ss, Ss, Ss, Ss, Ss, Ss, Ss, Ww, Ww, Gg, Gg, Re, Gg, Gg, Gg, Gg, Gg, Gs^Fds, Gs^Fds, Gs^Fds, Hh^Fms, Hh, Gs^Fds, Gs^Fds, Hh^Fms, Hh, Hh, Hh, Hh^Fms, Hh, Gg, Gg, Hh, Hh, Hh, Hh, Hh, Hh^Fms, Hh, Hh, Hh, Hh
Ww, Gg, Gg, Gg, Gs^Fds, Gs^Fds, Gs^Fds, Re, Gg, Gg, Gs, Gs^Eff, Gs, Gg^Eff, Gg, Gg, Gg, Gg, Gg, Gg, Gg, Gg, Gg, Gg, Gs^Fds, Gs^Fds, Ww, Ww, Ww, Gg^Fet, Ww, Ss, Ww, Ww, Ww, Ss, Ww, Ww, Ss, Gg, Gs^Vh, Gg, Re, Re, Re, Gg, Gg, Gg, Gg, Gs^Fds, Gg, Hh, Hh^Fms, Hh^Fms, Gg, Gg, Gg, Gs^Fds, Gg, Hh, Gg, Gg, Gg, Hh, Hh, Hh^Fms, Hh, Hh^Fms, Ww, Hh, Hh, Hh, Hh
Gg, Ww, Ww, Gg, Gs^Fds, Gg, Gg, Re, Gg, Gg, Gs, Gg, Gg, Gg, Gg, Gs^Fds, Gs^Fds, Gg, Gg, Gg, Gg, Gs^Fms, Gg, Gg, Gg, Gs^Fds, Gs^Fds, Ss, Ss, Ww, Ww, Ww, Wwg, Ss, Ss, Ww, Wwg, Ss, Ss, Gg, Gg, Re, Gg, Gg, Gg, Re, Gg, Gg, Gg, Gs^Fds, Gg, Hh^Fms, Hh^Fms, Hh, Gg, Gg, Hh, Gs^Fds, Gs^Fds, Gg, Gg, Gg, Gg, Gg, Gg, Hh, Hh^Fms, Ww, Ww, Ww, Hh^Fms, Hh, Hh
Gg, Ww, Ww, Gg, Gg, Gg, Gg, Re, Gg, Gg, Gg, Gs, Gg, Gg, Gg, Gs^Fds, Gg, Gs^Fds, Gg, Gg, Gg, Gg, Gg, Gg, Gg, Gs^Fms, Gg, Ss, Ss, Ww, Ss, Wwg, Ss, Ss, Ss, Wwg, Ss, Ss, Ss, Gg, Gg, Gg, Gg, Gg, Gg, Re, Gg, Gg, Gg, Gs^Fds, Gs^Fds, Gg, Gs^Fds, Gg, Gg, Hh, Hh^Fms, Hh, Gg, Gg, Hh, Hh, Hh, Gs^Fds, Gs^Fds, Ww, Ww, Ww, Ww, Ww, Mm, Hh, Hh
Gg, Gs^Fds, Gg, Ww, Gg, Gg, Gg, Re, Gg, Gg, Gs, Gg, Gg, Gg, Gg, Gg, Gg, Gg, Gg, Gg, Gg, Gg, Gg, Gg, Gg, Gg, Gg, Gg, Gg, Ss, Ss, Ss, Ss, Wwg, Ss, Ss, Wwg, Ss, Ss, Ss, Ss, Ss, Ss, Ss, Gg, Re, Gg, Gg, Gg, Gg, Gg, Gs^Fds, Gs^Fds, Gs^Fds, Gg, Hh, Hh^Fms, Hh^Fms, Gg, Gg, Hh, Hh, Hh, Gg, Gs^Fds, Ww, Ww, Hh^Fms, Hh^Fms, Ww, Mm, Hh, Hh
Gg, Gg, Gs^Fds, Ww, Gs^Fds, Gg, Gg, Re, Gg, Gg, Gg, Gg, Gg, Gg, Gg, Gs^Fds, Gs^Fds, Gs^Fds, Gg, Gg, Gg, Gg, Gg, Gg, Gg, Gg, Gg, Gg, Gg, Ss, Ss, Wwg, Wwg, Ss, Sm, Sm, Wwg, Sm, Ss, Ss, Gg, Ss, Ss, Gg, Gg, Re, Ss, Gg, Ss, Gg, Ss, Gg, Gg, Gg, Gg, Gs^Fds, Gg, Gg, Gs^Fds, Gs^Fds, Hh^Fms, Hh^Fms, Hh, Gg, Hh, Ww, Ww, Ww, Mm, Mm, Hh, Hh, Hh
Gg, Gg, Gs^Fds, Ww, Gs^Fds, Gg, Gg, Re, Gg, Gg, Gg, Gg, Gg, Gg, Gg, Gg, Gg, Gg, Gg, Gg, Gg, Gg, Gg, Gg, Gs^Fms, Gs^Fds, Gg, Gg, Ss, Gg, Ss, Ss, Ss, Ss, Sm, Wwg, Sm, Sm, Ss, Ss, Ss, Ss, Wwg, Ss, Ss, Ss^Bw|, Ss, Ss, Ss, Gg, Ss, Ss, Gg, Gg, Gg, Gs^Fds, Gg, Gg, Hh, Hh, Hh^Fms, Hh, Hh, Hh, Hh, Mm, Mm, Ww, Mm, Mm, Hh, Hh, Hh
Gg, Gg, Gg, Ww, Gg, Gs^Fds, Gg, Re, Re, Gg, Gg, Gg, Gg, Gg, Gg, Gg, Gg, Gg, Gg, Gg, Gg, Gg, Hh^Fds, Gg, Hh^Fds, Hh^Fds, Gs^Fms, Ss, Ss, Gg, Ss, Ss, Wwg, Ss, Wwg, Sm, Sm, Sm, Sm, Ss, Wwg, Wwg, Ss, Wwg, Wwg, Ss^Bw|, Ss, Ss, Ss, Ss, Gg, Ss, Ss, Ss, Ss, Gs^Fds, Gs^Fds, Gs^Fds, Hh, Hh, Hh^Fms, Hh, Hh, Hh, Mm, Mm, Mm, Wo, Mm, Mm, Mm, Hh, Hh
Gg, Gs^Fds, Gs^Fds, Ww, Ww, Gg, Gs^Fds, Gg, Gg, Re, Re, Gg, Gg, Gg, Gg, Gg, Gg, Gg, Gg, Gg, Gg, Gs^Fds, Gs^Fds, Hh^Fds, Gg, Gs^Fds, Re, Ss, Gg, Ss, Gg, Wwg, Ss, Ss, Ss, Sm, Ss, Sm, Sm, Wwg, Ss, Wwg, Ss, Wwg, Ss, Ss^Bw|, Wwg, Wwg, Ss, Ss, Wwg, Wwg, Ss, Wwg, Ss, Ss, Ss, Gg, Gs^Fds, Hh^Fms, Gg, Gg, Gg, Hh, Hh^Fms, Mm, Mm, Wo, Hh, Mm^Xm, Mm, Hh, Hh
Gg, Gg, Gg, Gg, Ww, Ww, Gg, Gs^Vh, Gg, Gg, Re, Re, Re, Gg, Gg, Gg, Gg, Gg, Gg, Gs, Re, Gg, Gg, Gg, Re, Gg, Ss, Ss, Ss, Ss, Ss, Ss, Ds, Wwg, Ss, Ss, Ss, Ss, Ss, Ss, Ss, Ss, Ss, Ss, Ss, Ss^Bw|, Wwg, Wwg, Wwg, Ss, Wwg, Wwg, Ss, Ss, Hh^Fds, Wwg, Wwg, Ss, Ss, Gg, Gg, Gg, Gg, Hh, Hh, Mm, Wo, Wo, Mm, Mm^Xm, Mm^Xm, Hh, Hh
Gg, Gg, Gg, Gs^Fds, Gg, Ww, Ww, Gg, Re, Re, Gg, Gg, Gg, Re, Re, Gg, Gg, Gg, Gs, Gg, Gg, Gg, Gg, Re, Gg, Ss, Ss, Ss, Ss, Ss, Gs, Ss, Ds, Wwg, Ss, Ss, Ss, Gg, Re, Re, Ss, Wwg, Wwg, Wwg, Ss, Re^Bw|, Ss, Ss, Ss, Ss, Ss, Ss, Gg, Hh^Fds, Hh^Fds, Ss, Ss, Ss, Ss, Ss, Ss, Gs^Fds, Wo, Hh, Wo, Wo, Hh^Fms, Hh^Fms, Mm, Mm, Hh, Hh, Hh
Gg, Gg, Gg, Gs^Fds, Gg, Gg, Re, Ww^Bw/, Ww, Gs^Fds, Gg, Gg, Gg, Gg, Gg, Re, Re, Re, Gg, Gg, Gg, Gg, Gg, Gg, Gg, Ss, Gg, Gg, Gg, Gg, Ss, Gs, Ds^Bw\r, Wwg, Ss, Gs, Ss, Ss, Ss, Ss, Gs, Gs, Gg, Wwg, Ss, Re, Gg, Ss, Gg, Gg, Gg, Gg, Gg, Gs^Fds, Hh^Fms, Hh^Fds, Hh, Ss, Wwg, Wwg, Wwg, Wwg, Hh, Wo, Hh, Hh^Fms, Hh^Fms, Hh^Fms, Hh, Mm, Hh, Hh, Hh
Gg, Gg, Gg, Gg, Gg, Gg, Gs^Vh, Gg, Ww, Gg, Gg, Gg, Gs^Fds, Gg, Gg, Gg, Re, Gg, Gg, Gg, Gg, Gg, Gg, Gg, Gg, Gg, Ss, Ss, Ss, Ss, Ss, Ss, Ds, Ww^Bw\r, Ds^Bw\r, Ss, Gg, Gg, Gs, Ss, Gs, Gs, Gg, Gs, Gg, Re, Gg, Gg, Gg, Gs^Fds, Hh^Fms, Gs^Fds, Hh^Fms, Gs^Fds, Hh^Fms, Hh, Hh^Fms, Hh, Hh, Hh, Hh, Gg, Hh, Hh, Hh, Hh, Hh^Fms, Hh, Hh, Hh^Fms, Hh^Fms, Hh, Hh
Gg, Gg, Gg, Gg, Gg, Gg, Gg, Gg, Gg, Ww, Ww, Gg, Gg, Gg, Gg, Gg, Re, Re, Gs^Vh, Gg, Gg, Gg, Gg, 1 Gg, Gg, Gg, Gg, Ss, Gg, Gg, Ds, Ss, Wwg, Wwg, Ss, Gs, Ss, Ss, Ss, Gs, Gg, Gs, Gs, Gs^Fds, Gg, Re, Re, Gg, Gg, Gg, Hh^Fms, Mm, Mm, Mm, Mm, Hh, Hh^Fms, Hh, Hh, Hh, Hh, Hh, Hh^Fms, Hh, Hh, Hh, Hh, Hh^Fms, Hh, Hh, Hh, Hh, Hh
Gg, Gg, Gg, Gs^Fms, Gg, Gg, Gg, Gg, Gg, Gg, Ww, Ww, Gs^Fds, Gg, Gg, Gg, Re, Gg, Gg, Gg, Gg, Gg, Gg, Gg, Gg, Gg, Ss, Ss, Ss, Ds, Wwg, Wwg, Wwg, Wwg, Ww, Ss, Ds, Ss, Gs, Gs, Gg, Gs, Gg, Gg, Gg, Gg, Gg, Re, Gg, Gg, Hh^Fms, Mm, Mm, Hh, Mm, Hh^Fms, Hh, Hh, Gg, Hh, Hh, Hh, Hh, Hh, Hh^Fms, Hh, Hh, Hh, Hh, Hh^Fms, Hh, Hh, Hh
Gg, Gs^Fds, Gg, Gs^Fds, Gs^Fms, Gs^Fds, Gs^Fms, Gg^Fet, Gg, Gg, Gg, Ww, Ww, Gg, Gs^Fds, Gg, Re, Gg, Gg, Gg, Ww, Gs^Fds, Gs^Fds, Gg, Gg, Ss, Wwg, Wwg, Ss, Wwg, Wwg, Wwg, Wo, Wwg, Wo, Ww, Ww, Ds, Ds, Gg, Gg, Gg, Gg, Gg, Gg, Gg, Gg, Re, Gg, Gg, Gs^Fds, Gg, Gs^Fds, Hh, Hh, Hh, Hh, Hh, Gg, Gg, Hh, Hh, Hh, Hh, Hh^Fms, Hh, Hh^Fms, Hh, Hh, Hh, Hh, Hh, Hh
Gg, Gs^Fms, Gs^Fds, Gs^Fds, Gs^Fds, Gs^Fds, Gs^Fds, Gg, Gg, Gg, Ww, Ww, Ww, Gg, Gg, Gg, Re, Gg, Ww, Ww, Ww, Ww, Ww, Ww, Ww, Wwg, Ss, Ss, Wwg, Wwg, Ss, Wo, Wwt, Wo, Wwt, Wo, Wo, Ww, Ww, Gg, Gg, Gg, Gg, Gg, Gg, Gs^Fms, Gg, Re, Gs^Vh, Gg, Gg, Gs^Fds, Hh, Mm, Mm, Hh^Fms, Gg, Gs^Fds, Gg, Gg, Gg, Hh, Hh, Hh, Hh^Fms, Hh, Hh^Fms, Hh, Hh, Hh^Fms, Hh^Fms, Hh^Fms, Hh^Fms
Ww, Gs^Fms, Ww, Gg, Ww, Gs^Fds, Ww, Ww, Ww, Ww, Ww, Ww, Ww, Ww, Ww, Ce, Ww, Ww^Bw\, Ww^Bw\, Ww, Ww, Ww, Ww, Ww, Ww, Ww, Ss, Ss, Ww, Ss, Wwt, Wwt, Wwt, Wwt, Gs, Ww, Ww, Wo, Wo, Ww, Ww, Ww, Ww, Gg, Gs^Fds, Gg, Gs^Fds, Re, Gg, Gg, Gg, Gs^Fds, Gs^Fds, Mm, Hh^Fms, Hh^Fms, Gs^Fds, Gs^Fds, Gg, Gg, Hh, Hh, Hh, Hh^Fms, Hh^Fms, Hh^Fms, Hh^Fms, Hh, Hh, Hh, Hh^Fms, Hh^Fms, Hh^Fms
Ww, Ww, Ww, Ww, Ww, Ww, Ww, Ww, Ww, Ww, Ww, Ww, Ww, Ww, Ww, Ww, Ww, Ww, Ww, Ww^Bw\, Ww, Ww, Ww, Wot, Wot, Ss, Wot, Ww, Wwt, Wwt, Gg, Gg, Gg, Wwt, Gs, Gs, Gs^Fds, Ww, Ww, Wo, Wo, Ww, Ww, Ww, Gg, Gg, Gs^Fds, Re, Re, Gg, Wwt, Gs^Fds, Gs^Fds, Hh^Fms, Gg, Gs^Fds, Gg, Gs^Fds, Gg, Hh, Hh, Hh, Hh^Fms, Hh^Fms, Hh^Fms, Hh^Fms, Hh, Hh, Hh^Fms, Hh^Fms, Hh^Fms, Hh^Fms, Hh
Ww, Ww, Ww, Ww, Ww, Ww, Ww, Ww, Ww, Ww, Ww, Ww, Ww, Ww, Ww, Ww, Ww, Ww, Ww, Ww^Bw|, Ww, Ww, Gs^Fds, Ww, Ww, Wot, Wwt, Wwt, Gg, Gs^Fds, Gs^Fds, Gg, Gg, Gg, Gs, Gg, Gs^Fds, Gs^Fms, Gs^Fds, Ww, Ww, Ww, Ww, Ww, Ww, Gg, Wwt, Re, Re, Wwt, Wwt, Gg, Wwt, Wwt, Gg, Gg, Gs^Fds, Gs^Fds, Gg, Hh, Hh, Hh, Hh, Hh, Hh, Hh^Fms, Ww, Hh^Fms, Mm, Mm, Mm, Mm, Mm
Ww, Ww, Ww, Ww, Gs^Fds, Gs^Fds, Gs^Fms, Gs^Fds, Gs^Fds, Ww, Gg, Gg, Gg, Ww, Ww, Ww, Ww, Ww, Gg, Re, Gg, Gg, Gs^Fds, Gs^Fds, Gs^Fds, Gg, Gs^Fds, Gg, Gg, Gg, Gs^Fms, Gs^Fms, Gg, Gs^Vh, Gg, Gg, Gg, Gg, Gg, Gs^Fds, Gs^Fds, Ww, Ww, Ww, Ww, Wwt, Wwt^Bw/, Wwt^Bw/, Wwt, Wwt, Ww, Wwt, Wwt, Wwt, Gs^Fds, Gs^Fds, Gs^Fds, Gg, Hh, Hh, Hh, Hh, Hh^Fms, Hh^Fms, Hh, Ww, Ww, Ww, Ww, Hh^Fms, Mm, Mm, Mm
Gg, Gs^Fds, Gg, Gs^Fds, Gg, Gg, Gs^Fms, Gg, Gg, Gg, Gg, Gg, Gg, Ce, 2 Ket, Ww, Ww, Ww, Gg, Re, Gg, Gg, Gs^Fds, Gs^Fms, Gs^Fds, Gs^Fds, Gg, Gg, Gg, Gg, Gg, Gs^Fms, Gg, Gg, Re, Gs, Re, Gg, Gg, Gs^Fds, Gs^Fms, Gs^Fds, Gg, Ww, Re, Re, Ww, Ww, Ww, Ww, Ww, Ww, Ww, Wwt, Wwt, Wwt, Wwt, Hh, Hh, Hh^Fms, Hh, Mm, Mm, Mm, Mm, Ww, Ww, Ww, Mm, Hh^Fms, Mm, Mm, Mm
Gg, Gg, Gg, Gg, Gg, Gg, Gg, Gg, Gg, Gg, Gg, Gg, Gg, Ce, Ce, Ce, Gg, Gg, Re, Re, Gg, Gg, Gg, Gs^Fms, Gs^Fds, Gs^Fms, Gs^Fds, Gs^Fms, Gs^Fms, Gg, Gg, Gg, Re, Re, Gg, Re, Gg, Re, Re, Gs^Fds, Gg, Gs^Fds, Re, Re, Gg, Gg, Gg, Ww, Gg, Ww, Ww, Ww, Ww, Ww, Ww, Ww, Ww, Hh^Fms, Hh^Fms, Hh^Fms, Hh, Hh^Fms, Mm, Mm, Hh, Ww, Ww, Ww, Mm, Mm, Hh^Fms, Hh^Fms, Hh
Gg, Gg, Gg, Gg, Gg, Gg, Gg, Gg, Gg, Gg, Gg, Gg, Gg, Gg, Re, Re, Re, Re, Gg, Gg, Gg, Gg, Gs^Fms, Gs^Fds, Gs^Fds, Gs^Fds, Gs^Fds, Gg, Gs^Fms, Gg, Re, Re, Gs^Fms, Gg, Gs^Fms, Gg, Gg, Gg, Gg, Re, Re, Re, Gg, Gg, Gg, Gg, Gg, Gg, Gg, Gg, Gg, Ww, Gg, Ww, Ww, Ww, Ww, Hh, Hh^Fms, Hh^Fms, Hh^Fms, Mm, Hh, Hh, Mm, Hh^Fms, Mm, Mm, Mm, Mm, Hh^Fms, Hh^Fms, Hh^Fms
Gg, Gg, Gg, Gg, Gg, Gg, Gg, Gg, Gg, Gg, Gg, Gg, Gg, Gg, Re, Re, Gg, Gg, Gg, Gg, Gg, Gg, Gs^Fds, Gs^Fms, Gg, Gs^Fms, Gs^Fms, Gs^Fms, Re, Re, Gg, Gg, Gg, Gs^Fds, Gg, Gg, Gg, Gg, Gg, Gg, Gg, Gs^Fds, Gg, Gg, Gg, Gg, Gg, Gg, Gg, Gg, Gg, Gg, Gg, Gg, Gg, Ww, Ww, Ww, Ww, Hh, Ww, Hh^Fms, Hh, Hh^Fms, Hh^Fms, Mm, Hh^Fms, Hh^Fms, Hh^Fms, Hh^Fms, Hh^Fms, Hh^Fms, Hh^Fms
Gg, Gg, Gg, Gg, Gg, Gg, Gg, Gg, Gg, Gg, Gg, Gg, Re, Re, Gg, Gg, Gg, Gg, Gg, Gg, Gg, Gg, Gs^Fds, Gg, Gs^Fds, Gs^Fms, Gs^Fms, Re, Gg, Gg, Gg, Gg, Gg, Gg, Gg, Gg, Gg, Gg, Gg, Gg, Gg, Gg, Gg, Gg, Gg, Gg, Gg, Gg, Gg, Gg, Gg, Gg, Gg, Gg, Gg, Ww, Ww, Ww, Ww, Ww, Ww, Ww, Ww, Hh, Hh, Hh, Hh, Hh^Fms, Hh^Fms, Hh^Fms, Hh, Hh^Fms, Gg