border_size=1
usage=map

Hh, Md, Md, Re, Re, Hh^Fms, Hh^Fms, Hh, Hh^Fms, Mm, Mm^Xm, Mm^Xm, Hh, Hh^Fp, Hh^Fp, Hh, Hh, Hh, Hh, Gs^Fms, Gs^Fms, Gs^Fms, Gs^Fms, Gg, Gg, Gg, Gg, Gg, Gs^Fms, Gg, Re, Gg, Gg, Gg, Gs^Fms, Gs^Fms, Gs^Fms, Gg, Ww, Gg, Gg, Gg, Gg, Gg, Gg, Gg, Gg, Ww, Ww, Gg, Gg, Gg, Gg, Gg, Gg, Gg, Gg, Gg, Gg
Hh^Fms, Hh, Hh^Fms, Hh^Fms, Gs^Fms, Re, Re, Hh^Fms, Gg, Hh, Gg, Mm^Xm, Hh^Fms, Hh, Hh^Fms, Hh, Hh^Fp, Hh^Fp, Hh, Gs^Fms, Gg, Gg, Gg, Gg, Gg, Gg, Gg, Gs^Fms, Gs^Fms, Gg, Re, Gg, 6 Ke, Gg, Gs^Fms, Gg, Ww, Ww, Gg, Gg, Gg, Gg, Gg, Gg, Gg, Gg, Gg, Gg, Gg, Ww, Ww, Gg, Gg, Gg, Gg, Gg, Gg, Gg, Gg
Md, Md, Ww, Ww, Ww, Ww, Gg, Gg, Gg, Gg, Gg, Hh^Fms, Gg, Hh^Fms, Hh^Fms, Hh^Fms, Gg, Hh^Fp, Gg, Gs^Fds, Gg^Fet, Gg, Gs^Fds, Ww, Ww, Gg, Ww, Gs^Fms, Gs^Fms, Gg, Re, Ce, Ww, Ww, Ww, Ww, Ww, Gg, Gg, Gg, Gg^Ecf, Gg, Gg, Gg, Gg, Gg, Gg, Gg, Gg, Gg, Gg, Ww, Ww, Gg, Ce, Gg, Ce, Gg, Ww
Ww, Ww, Md, Md, Hh, Ww, Ww, Ww, Ww, Gg, Gg, Gg, Gg, Gg, Gg, Gs^Fds, Gg, Gg, Re, Gs^Vh, Gs^Fds, Gg, Ww, Ww, Gs^Fds, Ww, Gs^Fms, Ww, Ww, Gg, Ww, Ww^Bw\, Re, Gg, Gg, Ww, Ww, Gg, Gg, Gg, Gg, Gg, Gg, Gg, Gg, Gg, Gg, Gg, Gg, Gg, Gg, Ww, Ww, Ww, Ww, 5 Ke, Ww, Ww, Gg
Hh, Hh, Mm^Xm, Mm^Xm, Mm^Xm, Mm, Mm^Xm, Gs^Fms, Hh^Fds, Ww, Ww, Gs^Fms, Gg, Gg, Ww, Gg, Re, Gg, Gg, Gg, Gg, Gs^Fds, Gg, Ww, Gg, Gll^Fmf, Ww, Ww, Gg, Ww, Ww, Ww, Gg, Re, Gg, Gg, Gg, Gg, Gg, Gg, Gg, Gg, Gg, Gg, Gg, Gg, Gg, Gg, Gg, Gg, Gg, Gg, Gg, Gg, Gg, Ww, Gg, Gg, Gg
Mm^Xm, Mm^Xm, Mm, Mm^Xm, Mm, Mm^Xm, Mm, Mm, Md, Md, Hh^Fds, Ww, Ww, Ww, Gs^Fds, Ww, Ww^Bw|, Gg, Gg, Gg^Ecf, Ww, Ww, Gg, Ww, Ww, Ww, Gg, Gg^Ecf, Gg, Gg, Gg, Ww, Gg, Re, Re, Gg, Gg, Gg, Gg, Gg, Gg, Gg, Gg, Gg, Gg, Gg, Gg, Gg, Gg^Ecf, Gg, Gg, Gg, Gs^Vh, Gg, Gg, Gg, Gg, Gg, Gg
Mm, Mm, Hh, Hh^Fms, Gs^Fds, Gs^Fds, Hh^Fms, Ww, Ww, Ww, Ww, Ww, Ww, Gs^Fds, Gs^Fms, Gs^Fds, Re, Ww, Ww, Gg, Ww, Ww, Ww, Ww, Gg, Gg, Gs^Fds, Gs^Fds, Gg, Gg, Gg^Vh, Gg, Gg, Gg, Re, Gg, Gg, Gg, Gs^Fms, Gg, Gg, Gg, Gg, Gg, Gg, Gg, Gg, Gg, Gg, Gg, Gg, Gg, Gg, Gg, Gg, Gs^Vh, Gg, Gg, Gg
Hh, Hh, Hh^Fms, Hh^Fp, Ww, Ww, Ww, Ww, Ww, Ww, Ww, Ww, Ww, Ww, Gs^Fds, Gs^Fds, Re, Gg, Re, Ww, Ce, 9 Ke, Gg, Gg, Gg, Gg, Gg, Gg, Gg, Gg, Gg, Gg, Gg, Gg, Re, Gg, Gg, Gg, Gg, Gg, Gg, Gg, Gg, Gg, Gg, Gg, Gg, Gg, Gg, Gg, Gg, Gg, Gg, Gg, Gg, Gg, Gg, Gg, Gg
Gg, Gg, Gg, Gg, Ww, Ww, Ww, Ww, Ww, Ww, Ww, Ww, Ww, Ww, Gs^Fds, Gg, Re, Re, Gg, Gg, Gg, Gg, Gg, Gg, Gg, Gg, Gs^Fds, Gg, Gg, Gg, Gg, Gg, Gg, Gg, Re, Gg, Gg, Gg, Gg, Gg, Gg, Gg, Gg, Gg, Gg, Gg, Gg, Gg, Gg, Gg, Gg, Gg, Gg, Gg, Gg, Gg, Gg, Gg, Re
Gg, Gg, Gg, Gg, Ww, Ww, Ww, Ww, Ww, Ww, Ww, Ww, Gs^Fms, Gs^Fds, Gs^Fds, Gg, Re, Gg, Gs^Fds, Gg, Gg, Gg, Gg, Gg, Gg, Gs^Fds, Gs^Fms, Gs^Fms, Gg, Gg, Gg, Gg, Gg^Vh, Gg, Re, Gg, Gg, Gg, Gg, Gg, Gg, Gg, Gg, Gg, Gg, Gg, Gg, Gg, Gg, Gg, Gg, Gg, Gg, Gg, Gg, Gg, Re, Re, Gg
Gg, Gg, Gg, Ww, Ww, Ww, Ww, Ww, Ww, Ww, Ww, Gs^Fds, Gs^Fds, Gs^Fds, Gg, Gg, Re, Gs^Fds, Gs^Fds, Gs^Fds, Gg, Gg, Gs^Fds, Gg, Gg, Gs^Fds, Gs^Fds, Gs^Fds, Gg, Gg, Gs^Fds, Gg, Gg, Gg, Gg, Re, Re, Gg, Gg, Gg, Gg, Gg, Gg, Gg, Gg, Gg, Gg, Gg, Gg, Gg, Gg, Gg, Gg, Gg, Re, Re, Gg, Gg, Gg
Gg, Gg, Gg, Gg, Gs^Fds, Ww, Gs^Fds, Ww, Gll^Fmf, Ww, Ww, Gs^Fds, Gs^Fds, Gs^Fds, Gg, Gg^Ecf, Re, Gs^Fds, Gs^Fms, Gs^Fds, Gs^Fds, Gg, Gs^Fms, Gg, Gg, Gg, Gg, Gg, Gg, Gg, Gg, Gg, Gg, Gg, Gs^Fds, Gs^Fds, Gg, Re, Re, Gg, Gg, Gg, Gg, Gg, Gg, Gg, Gg, Gg, Gg, Gg, Gg, Gg, Re, Re, Gg, Gg, Gg, Gg, Ww
Gg, Gg, Gg, Gg, Gg, Gs^Fds, Gs^Fds, Gs^Fms, Gs^Fds, Gs^Fds, Ww, Gg, Gg, Gg, Gs^Fds, Gg, Re, Gg, Gs^Fds, Gs^Fms, Gs^Fds, Gg, Gg, Gg, Gs^Fds, Gg, Gg, Gg^Ecf, Gg, Gg, Gg, Gg, Gg, Gg, Gg, Gg, Gg, Gg, Gg, Re, Re, Gg, Gg, Gg, Gg, Gg, Gg, Gg, Gg, Gg, Re, Re, Gs^Vh, Gg, Gg, Gg, Ww, Ww, Gg
Gg, Gg, Gg, Gs^Fds, Gg, Gg^Fet, Gg, Gll^Fmf, Gll^Fmf, Gs^Fds, Ww, Gg, Gs^Fds, Gg, Re, Re, Gll^Fmf, Gs^Fms, Gs^Fds, Gs^Fds, Gg, Gg, Gg, Gg, Gg, Gs^Fds, Gg, Gg, Gg, Gg, Gg, Gg, Gg, Gg, Gg, Gg, Gg, Gg, Gg, Gg, Gg, Re, Re, Gg, Gg, Gg, Gg, Gg, Re, Re, Gg, Gg, Gg, Gg, Ww, Ww, Gs^Fds, Gg, Gg
Gg, Gg, Gg^Ecf, Gg, Gg, Gg, Gs^Fds, Gg, Gg, Gg, Ww, Gg, Gs^Fds, Gg, Re, Gg, Gs^Fds, Gll^Fmf, Gs^Fds, Gg, Gs^Fds, Gg, Gg, Gg, Gg, Gg, Gs^Fds, Gs^Fds, Gs^Fds, Gg, Gg, Gg, Gg, Gg, Gs^Fms, Gs^Fms, Gs^Fms, Gg^Ecf, Gg, Gg, Gg, Gg, Gg, Re, Re, Gg, Re, Re, Gg, Gg, Gg, Gg, Ww^Bw\, Ww, Gg, Gg, Gs^Fds, Gg, Gg
Gg, Gg, Gg, Gg, Gs^Fds, Gs^Fds, Gg^Vh, Gg, Gg, Gg, Ww, Gs^Fds, Gg, Gg, Re, Gg, Gg, Gs^Fds, Gg, Gs^Fds, Gg, Gg, Gs^Fds, Gs^Fds, Gs^Fds, Gg, Gs^Fds, Gs^Fds, Gs^Fms, Gg, Gg, Gg, Gg, Gg, Gg, Gg, Gg, Gg, Gg, Gg, Gg, Gg, Gg, Gg, Re, Re, Gg, Gg, Gg, Gg^Wm, Gg, Ww, Gg, Gg, Gg, Gg, Gg, Gg, Gg
Gg, Gg, Gg, Gs^Fds, Gg, Gs^Fds, Gg, Gg, Ww, Ww, Gg, Gg^Fet, Gg, Gg, Re, Gg, Gg, Gg, Gs^Fds, Gg, Gg, Gg, Gs^Fds, Gs^Fds, Gs^Fms, Gg, Gg, Gs^Fms, Gs^Fms, Gg, Gg, Gg, Gg, Gg, Gg, Gg, Gg, Gg, Gg, Gg, Gg, Gg, Re, Re, Gg, Gg, Gg, Gg, Gg, Gg, Gs^Fds, Ww, Gg, Gg, Gg, Gg, Gg, Gg, Gg
Gg, Gg, Gg, Gs^Fds, Gg, Gg, Ww, Ww, Gg, Gg, Gg, Gg, Gg, Gg, Re, Gg, Gg, Gs^Fds, Gg, Gg, Gg, Gg, Gg, Gs^Fds, Gs^Fms, Gll^Fmf, Gs^Fms, Gs^Fds, Gs^Fds, Gs^Fds, Gg, Gg, Gg, Gg, Gg, Gg, Gg, Gg, Gg, Gg, Re, Re, Gg, Gg, Gg, Gg, Gg, Gg, Gg, Gs^Fds, Ww, Ww, Gs^Fds, Gs^Fms, Gg, Gg, Gg, Gg, Gs^Fds
Re, Gg, Gg, Gs^Fds, Gg, Gg, Ww, Gg, Gg^Vh, Gg, Gg, Gg, Gg, Gg, Re, Gg, Gg, Gg, Gg, Gg, Gg, Gg, Gg, Gs^Fds, Gs^Fms, Gs^Fms, Gs^Fds, Gs^Fds, Gs^Fds, Gs^Fds, Gg, Gg, Gg, Gg, Gg, Gg, Gg, Gg, Re, Re, Re, Gg, Gg, Gg, Gg, Gg, Gg, Gg, Gs^Fms, Gs^Fds, Ww, Ww, Gs^Fms, Gs^Fms, Gg, Gg, Gg, Gs^Fds, Gs^Fds
Gg, Re, Re, Gg, Gg, Ww, Gg, Gg, Re, Gg, Gg, Gg, Gg, Gg, Re, Gg, Gg, Gg, Gg, Gg, Gg, Gg, Gg, Gs^Fds, Gs^Fds, Gs^Fms, Gg, Gg, Gg, Gg, Gg, Gg^Ecf, Gg, Gg, Gg, Gg, Re, Re, Gg, Gg, Gg, Re, Re, Gg, Gg, Gg, Gg, Gg, Gg, Gs^Fms, Gs^Fms, Ww, Gs^Fds, Gs^Fds, Gg, Gg, Gg, Gg, Gs^Fds
Ww, Gg, Re, Gg, Ww, Ww, Gg, Gs^Vh, Re, Gg, Gg, Gg, Gg, Gg, Re, Gs^Fms, Gs^Fms, Gs^Fms, Gg, Gg, Gg, Gg, Gg, Gg, Gg, Gg, Gg, Gg, Gg, Gg, Gg, Gg, Gg, Gg, Re, Re, Gg, Gg, Gg, Gg, Gg, Gg, Gg, Re, Re, Gg, Gg, Gg, Gg, Gg, Gg, Ww, Gg, Gg, Gs^Vh, Gg, Gg, Gs^Fds, Gs^Fds
Gg, Ww, Ww, Ww^Bw\, Re, Gg, Gg, Gg, Re, Gs^Fms, Gs^Fms, Gg, Re, Re, Gs^Fms, Gs^Fms, Gg, Gg, Gg, Gg, Gg, Gg, Gg, Gg, Gg, Gg, Gg, Gg, Gg, Gg, Gg, Gg, Re, Re, Gg, Gg, Gg, Gg^Ecf, Gg, Gg, Gg, Gg, Gg, Gg, Gg, Re, Re, Gg, Gg, Gg, Gg, Ww, Gg, Gg, Gg, Gg, Gg, Gs^Fds, Gg
Gg, Gg, Ce, 7 Ke, Gg, Re, Re, Re, Gs^Fms, Gs^Fms, Re, Re, Gg, Gg, Gs^Fms, Gg, Gg, Gg, Gg, Gg^Ecf, Gg, Gg, Gg, Gg, Gg, Gg, Gg, Gg, Gg, Gg, Re, Re, Gg, Gg, Gg, Gg, Gg, Gg, Gg, Gg, Gg, Gg, Gg, Gg, Gg, Gg, Gg, Re, Re, Gg, Ww, Ww, Ce, Gg, Gg, Gg, Gg, Gg, Gg
Gg, Gg, Gg, Gg, Gs^Fms, Re, Re, Gs^Fms, Re, Re, Gg, Gg, Gg, Gs^Fms, Gg, Gg, Gg, Gg, Gg, Gg, Gg, Gg, Gg, Gg, Gg, Gg, Gg, Gg, Re, Re, Re, Gg, Gg, Gg, Gg, Gg, Gg, Gg, Gg, Gg, Gg, Gg, Gg, Gg, Gg, Gg, Ww, Ww, Ww, Ww^Bw\, Re, 4 Ke, Ce, Gg, Gg, Gg, Gg, Gg, Gg
Gg, Gg, Gg, Gg, Gs^Fms, Gs^Fms, Gg, Re, Gg, Gg, Gg, Gg, Gg, Gg, Gg, Gg, Gg, Gg, Gg, Gg, Gg, Gg, Gg, Gg, Gg, Gg, Re, Re, Gg, Gg, Gg^Ecf, Re, Re, Gg, Gg^Wm, Gg, Gg, Gg, Gg, Gg, Gg, Gg, Gg, Gg, Ww, Ww, Gg, Ww, Gg, Gg, Gg, Re, Gg, Gg, Gg, Gg, Gg^Ecf, Gg, Gg
Gg, Gg, Gg, Gg, Gg, Gg, Gg, Re, Gg, Gg, Gg, Gg, Gg, Gg, Gg, Gg, Gg, Gg, Gg, Gg, Gg, Gg, Gg, Gg, Re, Re, Gg, Gg, Gg, Gg, Gg, Gg, Gg^Vh, Re, Re, Gg, Gg, Gg, Gg, Gg, Gg, Gg, Ww, Ww, Gg, Gg, Gg, Gg, Gg, Gg, Gg, Re, Re, Gg, Gg, Gg, Gg, Gg, Gg
Gg, Gg, Gg, Gg, Gg, Gg, Gg, Re, Gg, Gg, Gg, Gg, Gg, Gg, Gg, Gg, Gg, Gg, Gg, Gg, Gg, Gg, Re, Re, Gg, Gg, Gg, Gg, Ww, Gg, Gs^Fms, Gg, Gg, Gg, Re, Gg, Ke, Gg, Gg, Gg, Ww, Ww, Gg, Gg, Gs^Vh, Gg, Gg, Gg, Gg, Gg, Gg, Gg, Gll^Fmf, Re, Re, Gg, Gg, Gg, Gg
Gg, Gg, Gg, Gg, Gg, Gg, Gg, Re, Gg, Gg^Ecf, Gg, Gg, Gg, Gg, Gg, Gg, Gg, Gg, Gs^Fds, Gg, Re, Re, Gg, Gg, Gg, Gs^Fms, Ww, Ww, Ww, Ww, Ww, Ww, Ww, Gs^Fds, Re, Ce, Ww, Ww, Ww, Ww, Gg, Gg, Gg, Gg, Gg, Gg, Gg, Gg, Gg, Gg, Gs^Fms, Gs^Fds, Gs^Fds, Gs^Fms, Gg, Re, Gg, Gg, Gg
Gg, Gg, Gg, Gg, Gg, Gg, Gg, Re, Gg, Gg, Gg, Gg, Gg, Gg, Gg, Gg, Gg, Gs^Fds, Re, Re, Gg, Gg, Gg, Gg, Ke, Ww, Hh^Fds, Ww, Hh^Fds, Gg, Gs^Fds, Ww, Ww, Ww, Ww^Bw|, Ww, Gs^Fds, Ww, Gs^Fms, Gg, Gg, Gg, Gg, Gg, Gg, Gg, Gg, Gg, Gg, Gs^Fms, Gs^Fms, Gll^Fmf, Gll^Fp, Gs^Fms, Gg, Re, Gg, Gg, Gg
Gs^Fds, Gg, Gg, Gg, Gg, Gg, Gg, Re, Gg, Gg, Gg, Gg, Gs^Fds, Gg, Gs^Fds, Gg, Re, Re, Gg, Gg, Gg, Gg, Gg, Gll^Fmf, Ww, Ww, Gs^Fms, Hh^Fds, Gg, Gs^Fds, Gg, Gg, Gg, Gg, Re, Gg, Gg, Gg, Gs^Fms, Gg, Gg, Gg, Gg, Gg, Gg, Gg, Gg, Gg, Gg, Gs^Fms, Gg, Gg, Gg, Gg, Gg, Re, Gg, Gg, Gg
Gs^Fds, Gs^Fds, Gg, Gg, Gg, Gg, Gg, Re, Gg, Gg, Gg, Gg, Gg, Gg, Re, Re, Gg, Gg, Gg, Gg^Vh, Gg, Gs^Fds, Ww, Ww, Gs^Fms, Gs^Fms, Gs^Fms, Gs^Fms, Hh^Fds, Gg, Gg, Gg, Gs^Fms, Gg, Re, Gs^Vh, Gg, Gs^Fms, Gg, Gg, Gg, Gg, Gg, Gg, Gg, Gg, Gg, Gg, Gg, Gg, Gg, Gg, Gg, Gg, Gg, Re, Gg, Gs^Fms, Gs^Fms
Gs^Fds, Gs^Fds, Gg, Gg, Gg, Gg, Gg, Re, Gg, Gg, Gg, Gg, Re, Re, Gg, Gg, Gg, Gs^Fds, Gg, Gg, Ww, Ww, Gg, Gg, Gs^Fms, Gs^Fms, Gs^Fms, Gs^Fms, Hh^Fds, Gg, Gs^Fms, Gs^Fms, Gg, Gg, Gs^Fms, Re, Re, Gg, Gg, Gg, Gg, Gg, Gg, Gg, Gg, Gg, Gg^Ecf, Gg, Gg, Gg, Gg, Gs^Fms, Gs^Fms, Gg, Gs^Vh, Re, Gg, Gg, Gg
Gs^Fds, Gg, Gg, Gg, Gg, Gg, Gg, Re, Gg, Gg, Re, Re, Gg, Gg, Gg, Gs^Fds, Gg, Gg, Ww, Ww, Hh^Fds, Ww, Hh^Fds, Gs^Fds, Hh^Fds, Gg, Gg, Hh^Fds, Gg, Gg, Gs^Fms, Gs^Fms, Gs^Fms, Gs^Fms, Gg, Gg, Gg, Re, Re, Gg, Gg, Gg, Gg, Gg, Gg, Gg, Gg, Gg, Gg, Gg, Gg, Gg, Gg, Gg, Gg, Re, Gg, Gg, Gg
Gs^Fds, Gs^Fds, Gs^Fds, Gs^Fds, Gs^Fms, Gg, Gg, Re, Re, Re, Gg, Gg, Gg, Gg, Ww, Ww, Ww, Ww, Gs^Fds, Hh^Fds, Hh^Fds, Ww, Hh^Fds, Hh, Gg, Gs^Fds, Gs^Fds, Gs^Fds, Gg, Gg, Gg, Gg^Ecf, Gs^Fms, Gs^Fms, Gg, Gg, Gg, Gg, Gg, Re, Re, Gg, Gg, Gg, Gg, Gg, Gg, Gs^Fms, Gs^Fds, Gs^Fms, Gg, Gg, Gg, Gg^Ecf, Gg, Re, Gg, Gg, Gs^Fms
Gs^Fds, Gs^Fds, Gs^Fms, Gs^Fds, Gs^Fds, Gg, Re, Re, Gg, Gg, Gs^Fds, Gg, Ww, Ww, Hh^Fds, Gg, Gs^Fds, Gs^Fds, Hh^Fmw, Hh^Fds, Hh, Ww, Ww, Hh^Fds, Gg, Gg, Gg, Gg, Gg, Gg, Gg, Gs^Fms, Gs^Fms, Gg, Gs^Fds, Gg, Gg, Gg, Gg^Ecf, Gg, Gg, Re, Re, Gg, Gg, Gg, Gg, Gs^Fds, Gs^Fms, Gs^Fms, Gg, Gg, Gg, Gg, Gg, Re, Gg, Gg, Gs^Fms
Gg, Gg, Gg, Gs^Fds, Gg, Re, Gs^Fds, Gg, Gg^Vh, Gg, Gg, Ww, Hh^Fds, Hh^Fds, Hh^Fds, Hh^Fds, Hh^Fds, Hh^Fmw, Hh, Hh, Gg^Ecf, Hh^Fds, Ww^Bw/, Gg, Gg, Gg, Gs^Fms, Gll^Fmf, Hh^Fmw, Hh, Gg, Gg, Gg, Gg, Gg, Gs^Fds, Gg, Gg, Gg, Gg, Gg, Gg, Gg, Re, Re, Gg, Gg, Gg, Gg, Gg, Gg, Gg, Gg, Gg, Gg, Re, Gg, Gg, Gg
Gs^Fds, Gs^Fds, Gs^Fms, Gg, Gg, Re, Gs^Fds, Gg, Gg, Gg, Ww, Ww, Ww, Ww, Hh^Fds, Hh^Fds, Hh^Fds, Hh^Fmw, Hh, Gg, Gg, Gg, Ww, Gg, 8 Ke, Gg, Gs^Fms, Gs^Fms, Gg, Gg, Gg, Gg, Hh^Fmw, Gg, Gg, Gs^Fds, Gg, Gg, Gg, Gg, Gg, Gg, Gg, Gg, Re, Gg, Gg, Gg, Gg, Gg, Gg, Ww, Ww, Gg, Ce, Ce, Ce, Gg, Gg
Gs^Fds, Gs^Fds, Gs^Fds, Gg, Gg, Re, Gg, Gg, Gg, Ww, Gg, Gg, Hh^Fds, Ww, Hh^Fds, Hh^Fds, Hh^Fds, Hh^Fmw, Gs^Fms, Gg, Hh, Gg, Hh, Ww, Ww, Ce, Ww, Gs^Fms, Gg, Gs^Vh, Gg, Hh, Hh^Fmw, Hh^Fmw, Gll^Fmf, Hh^Fmw, Hh^Fmw, Gg, Hh^Fmw, Gg, Gg, Gg, Gg, Gg, Re, Gg, Gg, Gg, Gg, Gg, Gg, Ww, Ww, Ww, Ww, 3 Ke, Gg, Gg, Gg
Gg, Gs^Fds, Gg, Gg, Gs^Fds, Re, Gg, Gg, Ww, Ww, Gg, Gs^Fds, Gg, Hh^Fds, Hh^Fds, Hh^Fds, Hh^Fds, Hh^Fmw, Gg, Gg, Hh^Fp, Hh, Hh^Fmw, Hh^Fms, Ww, Ww, Ww, Ww, Ww, Gg, Md, Md, Hh^Fmw, Hh^Fmw, Hh^Fp, Hh^Fmw, Hh^Fmw, Hh^Fmw, Mm, Gg, Gg, Gg, Gg, Gg, Re, Gg, Gg, Gg, Gg, Gs^Vh, Gs^Fms, Ww, Ww, Ww, Ww, Gg, Gs^Fms, Gg, Gg
Gg, Gg, Gg, Gg, Gg, Re, Gg, Gg, Ww, Ww, Gg, Gg, Gg, Gs^Fds, Gs^Fds, Gg, Gg, Gg, Hh^Fmw, Hh^Fp, Hh^Fms, Hh^Fmw, Hh^Fmw, Hh^Fms, Ww, Ww, Ww, Ww, Mm, Ww, Mm, Mm, Hh^Fp, Hh^Fp, Mm, Hh, Hh^Fmw, Hh^Fmw, Mm, Gg, Gg, Gg, Gg, Gg, Re, Gg, Gg, Gg, Gg, Gg, Gg, Gs^Fms, Ww, Ww, Ww, Ww, Ww, Ww, Ww
Ww, Ww, Ww, Gg, Gg, Re, Gg, Gg, Ww, Ww, Gs^Fds, Gg^Vh, Gg, Gg, Gg, Gg, Gg, Gg, Hh^Fp, Hh^Fp, Hh^Fmw, Hh^Fmw, Hh^Fms, Hh^Fms, Hh^Fmw, Md, Md, Ww, Ww, Mm, Md, Hh^Fmw, Hh^Fp, Hh, Mm, Hh^Fms, Hh^Fmw, Mm, Hh, Gg, Gg, Gg, Gg, Gg, Re, Gg, Gg, Gg, Gg, Gg, Ww, Ww, Ww, Ww, Ww, Ww, Ww, Ww, Ww
Gg, Gg, Gg, Ww, Ww^Bw/, Re, Ce, 2 Ke, Ww, Ww, Gg, Gg, Gg, Gs^Fms, Gs^Fms, Hh^Fds, Gs^Fms, Hh^Fmw, Gs^Fms, Hh^Fmw, Hh^Fmw, Hh^Fmw, Hh^Fp, Hh^Fp, Hh^Fp, Hh^Fms, Hh^Fmw, Ww, Ww, Hh^Fmw, Hh^Fp, Hh^Fp, Hh^Fmw, Mm, Hh^Fms, Hh^Fms, Gg, Hh, Hh^Fmw, Gg, Gs^Vh, Gg, Gg, Gs^Fms, Ce, Ke, Ce, Gg, Ww, Ww, Gg, Gg, Gs^Fms, Ww, Hh^Fms, Hh^Fms, Hh^Fms, Ww, Ww
Gg, Gg, Gg, Re, Gg, Ww, Ww, Ce, Ww, Ww, Gg, Gg, Gg, Gs^Fms, Gs^Fms, Gg, Gs^Fms, Gg, Gg, Gs^Fms, Hh^Fms, Hh^Fp, Hh^Fp, Hh^Fmw, Hh^Fmw, Hh^Fp, Ww, Ww, Mm, Hh^Fp, Hh^Fmw, Hh^Fmw, Ww, Gg, Gg, Gg, Gg, Gs^Fms, Gs^Fms, Gg, Gg, Gg, Ww, Gg, Ww, Ww, Ww, Ww, Gg, Gg, Gg, Gs^Fms, Hh^Fms, Hh^Fms, Hh, Hh^Fms, Hh, Hh^Fms, Hh^Fms
Gg, Gg, Gs^Fds, Re, Re, Gg, Gg, Ww, Gg, Gg, Gg, Gg, Gg, Gg, Gs^Fms, Gs^Fms, Gs^Fms, Gg, Gs^Fms, Hh^Fmw, Hh^Fmw, Hh^Fp, Hh^Fp, Hh^Fmw, Hh^Fmw, Mm, Ww, Mm, Mm, Mm, Mm, Ww, Ww, Ww, Ww, Gg, Gs^Fms, Gs^Fms, Ww, Gg, Ww, Ww, Gg, Ww, Gg, Ww, Hh^Fms, Gg, Gg, Gg, Gg, Hh^Fms, Hh^Fms, Hh^Fms, Gs^Fds, Hh^Fms, Hh, Hh^Fms, Hh^Fms
Gg, Gs^Fds, Gs^Fms, Gs^Fds, Re, Gg, Gg, Gg, Gg^Ecf, Gg, Gg, Gg, Hh^Fds, Gg, Gs^Fms, Hh^Fds, Hh^Fds, Gg, Gs^Fms, Gg, Hh, Hh^Fp, Hh^Fmw, Hh^Fmw, Mm, Mm, Ww, Mm, Mm, Mm, Ww, Ww, Hh^Fms, Hh^Fms, Hh^Fms, Ww, Ww, Ww, Wwt, Ww, Gs^Fms, Gs^Fms, Gg, Gg, Gg, Gs^Fms, Hh^Fms, Gg, Gg, Gg, Hh, Hh^Fms, Hh^Fms, Hh^Fms, Hh^Fds, Hh, Hh, Hhd^Fdf, Hh^Fds
Gg, Gs^Fds, Gs^Fds, Gg, Re, Gg, Gs^Vh, Gg, Gg, Gg, Gg, Hh^Fds, Hh^Fds, Hh^Fds, Hh^Fds, Hh^Fds, Hh^Fds, Hh^Fds, Hh^Fms, Gs^Fms, Hh, Hh^Fmw, Hh^Fmw, Hh^Fmw, Mm, Hh^Fmw, Hh^Fmw, Ww, Ww, Ww, Hh^Fms, Hh^Fms, Hh^Fmw, Hh^Fmw, Mm, Mm, Ww, Wwt, Wwt, Gg, Gg, Gg, Gg, Gg, Gs^Fms, Hh^Fms, Gll^Fmf, Hh^Fms, Hh^Fds, Gs^Fds, Gs^Fds, Hh^Fms, 1 Hh^Fds, Hh, Hh, Hh^Fds, Hh^Fds, Hh^Fds, Hh^Fds
Gg, Gg, Gg, Gg, Re, Gg, Gg, Gg, Gs^Fms, Gg, Gs^Fms, Gg, Gs^Fms, Gs^Fms, Hh^Fds, Hh^Fds, Hh^Fds, Hh, Hh^Fmw, Hh^Fp, Hh, Hh, Hh, Mm, Hh^Fmw, Hh^Fmw, Hh^Fp, Hh^Fp, Hh^Fmw, Hh^Fms, Mm, Hh^Fmw, Hh^Fmw, Hh^Fmw, Hh, Hh, Hh^Fmw, Hh, Hh^Fp, Gg, Gg, Gg^Ecf, Gg, Gs^Fds, Gs^Fms, Hh^Fms, Gs^Fds, Gs^Fds, Hh^Fms, Gs^Fds, Hh, Hh, Hh^Fds, Hh, Hh^Fms, Hh^Fms, Gll^Fmf, Hh^Fds, Hh^Fds
Gs^Fds, Gs^Fms, Gs^Fds, Gg, Re, Gg, Gg, Gg, Gg, Gs^Fms, Gg, Gs^Fms, Gs^Fms, Gs^Fms, Gs^Fms, Hh^Fds, Hh^Fmw, Hh^Fmw, Hh^Fp, Hh^Fp, Hh, Hh^Fp, Hh, Hh^Fmw, Hh, Hh^Fmw, Hh^Fmw, Hh^Fp, Mm, Hh^Fms, Hh^Fmw, Mm, Hh^Fmw, Hh^Fmw, Hh^Fmw, Hh, Hh^Fmw, Gs^Fds, Gs^Fds, Gs^Fds, Gs^Fms, Gs^Fms, Gs^Fms, Gs^Fms, Gs^Fds, Hhd^Fdf, Hh^Fms, Hh^Fms, Hh, Hh, Hh^Fds, Hh^Fds, Hh, Hh, Hh^Fms, Hh^Fms, Hh^Fms, Hh^Fds, Hh^Fds
Gs^Fds, Gll^Fmf, Gs^Fds, Gg, Re, Gg, Gg, Gg, Gg, Gll^Fmf, Gg, Gs^Fms, Gs^Fms, Gs^Fms, Gs^Fms, Gs^Fms, Gs^Fms, Hh^Fp, Hh^Fmw, Hh, Hh, Hh, Hh^Fmw, Hh, Hh^Fmw, Hh^Fmw, Hh^Fmw, Mm, Hh^Fmw, Hh^Fmw, Hh^Fmw, Hh^Fmw, Hh^Fmw, Hh^Fmw, Hh^Fp, Hh^Fmw, Gll^Fmf, Gs^Fds, Hh^Fmw, Gs^Fms, Gg, Gs^Fms, Gg, Gg, Hh^Fds, Hh^Fds, Hh^Fds, Hh^Fms, Mm, Hh, Hh^Fms, Hh^Fms, Hh^Fms, Hh^Fds, Mm, Hh^Fms, Mm, Hh^Fds, Hh^Fds
Gg, Gs^Fds, Gg, Gg, Re, Gg, Gg, Gg, Gg, Gg, Gs^Fms, Gs^Fms, Gs^Fms, Gs^Fms, Gs^Fms, Gs^Fms, Hh^Fmw, Hh^Fmw, Hh^Fmw, Hh^Fmw, Gg, Hh^Fmw, Hh^Fmw, Hh^Fmw, Hh^Fmw, Hh^Fmw, Hh^Fmw, Hh^Fmw, Hh^Fmw, Hh^Fmw, Hh^Fmw, Hh^Fmw, Hh^Fmw, Hh^Fmw, Hh^Fmw, Hh^Fmw, Hh^Fmw, Hh^Fmw, Hh^Fmw, Hh^Fds, Hh^Fds, Gg, Gg, Gg, Hh^Fds, Hh^Fds, Hh^Fds, Mm, Mm, Hh^Fds, Hh^Fms, Hh^Fms, Hh^Fms, Mm, Mm, Mm, Mm, Hh^Fds, Hh^Fds
